"","int","age","period","cohort","y","c.cohort","c.period","age2"
"1",1,29,19,-10,-25.7681257762629,4.8174,-4.1206,11
"2",1,21,25,4,-11.9838277536874,-9.1826,-10.1206,3
"3",1,18,7,-11,-19.0582854374114,5.8174,7.8794,0
"4",1,18,28,10,-6.05377351911059,-15.1826,-13.1206,0
"5",1,15,24,9,-4.30198183347194,-14.1826,-9.1206,-3
"6",1,21,10,-11,-20.7066063099152,5.8174,4.8794,3
"7",1,21,11,-10,-20.3312262068009,4.8174,3.8794,3
"8",1,23,0,-23,-29.1592181157769,17.8174,14.8794,5
"9",1,15,16,1,-9.29889010915781,-6.1826,-1.1206,-3
"10",1,19,26,7,-8.56223258649217,-12.1826,-11.1206,1
"11",1,20,0,-20,-25.3420060665603,14.8174,14.8794,2
"12",1,19,7,-12,-20.0466730655729,6.8174,7.8794,1
"13",1,16,30,14,-2.38484200497492,-19.1826,-15.1206,-2
"14",1,17,27,10,-5.32061526274728,-15.1826,-12.1206,-1
"15",1,19,20,1,-12.16995949124,-6.1826,-5.1206,1
"16",1,26,25,-1,-18.0114113470632,-4.1826,-10.1206,8
"17",1,15,8,-7,-14.468052103785,1.8174,6.8794,-3
"18",1,16,13,-3,-12.2843383604292,-2.1826,1.8794,-2
"19",1,20,8,-12,-20.449226467595,6.8174,6.8794,2
"20",1,18,18,0,-12.237617625674,-5.1826,-3.1206,0
"21",1,18,12,-6,-15.9504162546966,0.8174,2.8794,0
"22",1,22,16,-6,-18.6292745906742,0.8174,-1.1206,4
"23",1,16,10,-6,-14.2215174344823,0.8174,4.8794,-2
"24",1,25,19,-6,-20.6437883237781,0.8174,-4.1206,7
"25",1,21,24,3,-12.2564867982432,-8.1826,-9.1206,3
"26",1,17,22,5,-8.41227951383954,-10.1826,-7.1206,-1
"27",1,24,14,-10,-22.0253408142529,4.8174,0.8794,6
"28",1,31,13,-18,-31.9241372002278,12.8174,1.8794,13
"29",1,17,30,13,-3.57553657035245,-18.1826,-15.1206,-1
"30",1,16,19,3,-8.94124842720007,-8.1826,-4.1206,-2
"31",1,24,24,0,-16.5259742079953,-5.1826,-9.1206,6
"32",1,25,3,-22,-30.1703075742895,16.8174,11.8794,7
"33",1,21,3,-18,-24.774783519983,12.8174,11.8794,3
"34",1,30,22,-8,-25.3681606860508,2.8174,-7.1206,12
"35",1,19,10,-9,-18.2345585808112,3.8174,4.8794,1
"36",1,15,9,-6,-13.6884045435229,0.8174,5.8794,-3
"37",1,16,13,-3,-12.5671821707771,-2.1826,1.8794,-2
"38",1,17,10,-7,-15.2901334937948,1.8174,4.8794,-1
"39",1,18,3,-15,-21.0198112275566,9.8174,11.8794,0
"40",1,14,9,-5,-12.3709515603549,-0.1826,5.8794,-4
"41",1,24,9,-15,-25.3611406611176,9.8174,5.8794,6
"42",1,16,7,-9,-16.1797888499514,3.8174,7.8794,-2
"43",1,25,20,-5,-20.015189235471,-0.1826,-5.1206,7
"44",1,27,15,-12,-25.5681773032726,6.8174,-0.1206,9
"45",1,22,23,1,-14.4240246714483,-6.1826,-8.1206,4
"46",1,15,11,-4,-12.5714461521535,-1.1826,3.8794,-3
"47",1,20,9,-11,-20.0522891874451,5.8174,5.8794,2
"48",1,32,23,-9,-27.2057612434066,3.8174,-8.1206,14
"49",1,24,25,1,-15.8354428030101,-6.1826,-10.1206,6
"50",1,22,6,-16,-24.3613626001984,10.8174,8.8794,4
"51",1,25,22,-3,-18.7860333199786,-2.1826,-7.1206,7
"52",1,25,14,-11,-23.3868112975252,5.8174,0.8794,7
"53",1,25,20,-5,-20.0668891932931,-0.1826,-5.1206,7
"54",1,13,11,-2,-9.66587978339831,-3.1826,3.8794,-5
"55",1,16,26,10,-4.7788254413511,-15.1826,-11.1206,-2
"56",1,23,24,1,-15.1250837608369,-6.1826,-9.1206,5
"57",1,17,5,-12,-18.7557607445648,6.8174,9.8794,-1
"58",1,25,14,-11,-23.5049429899594,5.8174,0.8794,7
"59",1,21,16,-5,-17.295921061652,-0.1826,-1.1206,3
"60",1,32,1,-31,-40.4072064591722,25.8174,13.8794,14
"61",1,23,10,-13,-23.7205715561358,7.8174,4.8794,5
"62",1,18,4,-14,-20.3105952675146,8.8174,10.8794,0
"63",1,11,15,4,-4.89377527238514,-9.1826,-0.1206,-7
"64",1,21,23,2,-13.0834767685387,-7.1826,-8.1206,3
"65",1,20,8,-12,-21.0913850679991,6.8174,6.8794,2
"66",1,20,21,1,-12.9499334237012,-6.1826,-6.1206,2
"67",1,22,25,3,-13.04957184044,-8.1826,-10.1206,4
"68",1,21,9,-12,-21.4245490012994,6.8174,5.8794,3
"69",1,18,10,-8,-16.8290174934998,2.8174,4.8794,0
"70",1,18,26,8,-7.30988065026751,-13.1826,-11.1206,0
"71",1,20,0,-20,-25.3433382697732,14.8174,14.8794,2
"72",1,18,14,-4,-14.5442766658375,-1.1826,0.8794,0
"73",1,24,25,1,-15.5829591133091,-6.1826,-10.1206,6
"74",1,23,7,-16,-25.1260495830411,10.8174,7.8794,5
"75",1,19,15,-4,-15.1631378925709,-1.1826,-0.1206,1
"76",1,15,19,4,-7.67231102735532,-9.1826,-4.1206,-3
"77",1,19,27,8,-8.14322977936818,-13.1826,-12.1206,1
"78",1,10,3,-7,-10.6922261149155,1.8174,11.8794,-8
"79",1,20,6,-14,-21.854398123849,8.8174,8.8794,2
"80",1,28,22,-6,-22.7096254828049,0.8174,-7.1206,10
"81",1,24,6,-18,-26.9264993473709,12.8174,8.8794,6
"82",1,22,22,0,-14.9358762861478,-5.1826,-7.1206,4
"83",1,24,1,-23,-29.8913639178062,17.8174,13.8794,6
"84",1,32,29,-3,-23.7746973231868,-2.1826,-14.1206,14
"85",1,13,7,-6,-12.2147020291662,0.8174,7.8794,-5
"86",1,19,24,5,-9.83456553648912,-10.1826,-9.1206,1
"87",1,14,3,-11,-15.8239282209919,5.8174,11.8794,-4
"88",1,19,18,-1,-13.4308544359708,-4.1826,-3.1206,1
"89",1,18,27,9,-6.5992697767288,-14.1826,-12.1206,0
"90",1,16,15,-1,-11.4499592821044,-4.1826,-0.1206,-2
"91",1,22,16,-6,-18.4027177020094,0.8174,-1.1206,4
"92",1,21,3,-18,-24.9394670897897,12.8174,11.8794,3
"93",1,13,1,-12,-16.0087633857382,6.8174,13.8794,-5
"94",1,15,25,10,-4.15321220880277,-15.1826,-10.1206,-3
"95",1,20,24,4,-11.0262030950061,-9.1826,-9.1206,2
"96",1,15,11,-4,-12.3838950744395,-1.1826,3.8794,-3
"97",1,17,13,-4,-13.8422003234833,-1.1826,1.8794,-1
"98",1,20,19,-1,-13.8929844306124,-4.1826,-4.1206,2
"99",1,18,6,-12,-19.3127025675286,6.8174,8.8794,0
"100",1,26,28,2,-16.7154175520372,-7.1826,-13.1206,8
"101",1,16,30,14,-2.36608505603268,-19.1826,-15.1206,-2
"102",1,17,28,11,-4.9137702486619,-16.1826,-13.1206,-1
"103",1,21,18,-3,-15.9188652854184,-2.1826,-3.1206,3
"104",1,22,9,-13,-22.7592790715944,7.8174,5.8794,4
"105",1,20,2,-18,-24.2313760950334,12.8174,12.8794,2
"106",1,16,27,11,-4.17238020486776,-16.1826,-12.1206,-2
"107",1,23,14,-9,-21.1284987923931,3.8174,0.8794,5
"108",1,21,18,-3,-16.0334154111223,-2.1826,-3.1206,3
"109",1,13,11,-2,-9.70876227178316,-3.1826,3.8794,-5
"110",1,15,29,14,-1.5543665877694,-19.1826,-14.1206,-3
"111",1,16,8,-8,-15.3469680379803,2.8174,6.8794,-2
"112",1,27,17,-10,-24.2434898042186,4.8174,-2.1206,9
"113",1,22,1,-21,-27.5319380294491,15.8174,13.8794,4
"114",1,20,6,-14,-22.1133759161562,8.8174,8.8794,2
"115",1,13,21,8,-3.59075351692873,-13.1826,-6.1206,-5
"116",1,21,28,7,-10.189286245216,-12.1826,-13.1206,3
"117",1,18,3,-15,-21.3000124039831,9.8174,11.8794,0
"118",1,20,13,-7,-17.5476025446763,1.8174,1.8794,2
"119",1,20,13,-7,-17.7149731487502,1.8174,1.8794,2
"120",1,24,4,-20,-28.560229709885,14.8174,10.8794,6
"121",1,23,1,-22,-28.7609669349562,16.8174,13.8794,5
"122",1,14,22,8,-4.27591922015402,-13.1826,-7.1206,-4
"123",1,17,23,6,-7.6149085717294,-11.1826,-8.1206,-1
"124",1,22,13,-9,-20.6346592790979,3.8174,1.8794,4
"125",1,22,28,6,-11.140535284464,-11.1826,-13.1206,4
"126",1,25,24,-1,-17.6153145371562,-4.1826,-9.1206,7
"127",1,18,24,6,-8.44506775727575,-11.1826,-9.1206,0
"128",1,23,20,-3,-17.492079619465,-2.1826,-5.1206,5
"129",1,25,9,-16,-26.6852740771796,10.8174,5.8794,7
"130",1,15,29,14,-1.70426267726313,-19.1826,-14.1206,-3
"131",1,23,17,-6,-19.3600204203814,0.8174,-2.1206,5
"132",1,22,21,-1,-15.5589051684787,-4.1826,-6.1206,4
"133",1,22,5,-17,-25.1485584638387,11.8174,9.8794,4
"134",1,14,5,-9,-14.6173155748901,3.8174,9.8794,-4
"135",1,16,23,7,-6.51795561767972,-12.1826,-8.1206,-2
"136",1,23,0,-23,-29.0802634851326,17.8174,14.8794,5
"137",1,17,9,-8,-15.9303051218938,2.8174,5.8794,-1
"138",1,18,25,7,-7.96194528622866,-12.1826,-10.1206,0
"139",1,20,1,-19,-25.1597985446524,13.8174,13.8794,2
"140",1,31,4,-27,-37.2924699690302,21.8174,10.8794,13
"141",1,22,9,-13,-22.5666421112987,7.8174,5.8794,4
"142",1,20,4,-16,-23.0147098788997,10.8174,10.8794,2
"143",1,19,11,-8,-17.5502080243819,2.8174,3.8794,1
"144",1,16,28,12,-3.41635692432394,-17.1826,-13.1206,-2
"145",1,13,0,-13,-16.4080827385247,7.8174,14.8794,-5
"146",1,31,5,-26,-36.8994373150948,20.8174,9.8794,13
"147",1,17,21,4,-8.98736924851307,-9.1826,-6.1206,-1
"148",1,18,9,-9,-17.321355453254,3.8174,5.8794,0
"149",1,16,23,7,-6.47986371642328,-12.1826,-8.1206,-2
"150",1,29,27,-2,-20.7274791797656,-3.1826,-12.1206,11
"151",1,14,1,-13,-17.1491053133015,7.8174,13.8794,-4
"152",1,25,27,2,-15.5378041173248,-7.1826,-12.1206,7
"153",1,22,14,-8,-19.8539826182475,2.8174,0.8794,4
"154",1,21,26,5,-11.1264441844975,-10.1826,-11.1206,3
"155",1,15,20,5,-7.1411020872548,-10.1826,-5.1206,-3
"156",1,17,29,12,-4.41232531272543,-17.1826,-14.1206,-1
"157",1,14,28,14,-0.95228854001471,-19.1826,-13.1206,-4
"158",1,26,9,-17,-27.881482164999,11.8174,5.8794,8
"159",1,16,28,12,-3.57865507205195,-17.1826,-13.1206,-2
"160",1,23,3,-20,-27.5616692926534,14.8174,11.8794,5
"161",1,17,21,4,-8.93332689955611,-9.1826,-6.1206,-1
"162",1,15,8,-7,-14.3319784411975,1.8174,6.8794,-3
"163",1,15,9,-6,-13.7880790627986,0.8174,5.8794,-3
"164",1,18,21,3,-10.2593106066214,-8.1826,-6.1206,0
"165",1,28,7,-21,-31.6623871416513,15.8174,7.8794,10
"166",1,18,10,-8,-16.5630761621353,2.8174,4.8794,0
"167",1,19,1,-18,-23.5999113651543,12.8174,13.8794,1
"168",1,21,27,6,-10.3856683792131,-11.1826,-12.1206,3
"169",1,17,28,11,-4.57991552181173,-16.1826,-13.1206,-1
"170",1,25,19,-6,-20.4779008319859,0.8174,-4.1206,7
"171",1,15,21,6,-6.40438600345213,-11.1826,-6.1206,-3
"172",1,19,1,-18,-23.9849027899249,12.8174,13.8794,1
"173",1,21,25,4,-11.7204320870361,-9.1826,-10.1206,3
"174",1,27,3,-24,-32.7206051610563,18.8174,11.8794,9
"175",1,16,25,9,-5.33068322191467,-14.1826,-10.1206,-2
"176",1,19,6,-13,-20.5605339510749,7.8174,8.8794,1
"177",1,16,2,-14,-18.9320538890045,8.8174,12.8794,-2
"178",1,15,4,-11,-16.8069878430087,5.8174,10.8794,-3
"179",1,21,29,8,-9.39406339647032,-13.1826,-14.1206,3
"180",1,27,14,-13,-26.1437969079535,7.8174,0.8794,9
"181",1,29,15,-14,-28.2006536676453,8.8174,-0.1206,11
"182",1,28,6,-22,-32.2529967273469,16.8174,8.8794,10
"183",1,17,17,0,-11.4725490417187,-5.1826,-2.1206,-1
"184",1,25,20,-5,-20.0344988220523,-0.1826,-5.1206,7
"185",1,26,2,-24,-32.0375823743191,18.8174,12.8794,8
"186",1,21,26,5,-11.2782615586919,-10.1826,-11.1206,3
"187",1,21,27,6,-10.5788872744495,-11.1826,-12.1206,3
"188",1,19,3,-16,-22.2269440294581,10.8174,11.8794,1
"189",1,19,9,-10,-18.9378341802816,4.8174,5.8794,1
"190",1,16,12,-4,-13.1959815936701,-1.1826,2.8794,-2
"191",1,21,20,-1,-14.6605414769459,-4.1826,-5.1206,3
"192",1,29,30,1,-19.3153048047088,-6.1826,-15.1206,11
"193",1,22,8,-14,-23.483605579336,8.8174,6.8794,4
"194",1,27,2,-25,-33.6250667590028,19.8174,12.8794,9
"195",1,22,4,-18,-25.7033772714056,12.8174,10.8794,4
"196",1,30,20,-10,-26.5421607934904,4.8174,-5.1206,12
"197",1,25,1,-24,-31.3927681877059,18.8174,13.8794,7
"198",1,32,25,-7,-26.18902455331,1.8174,-10.1206,14
"199",1,23,6,-17,-25.553025633629,11.8174,8.8794,5
"200",1,18,7,-11,-18.723820897697,5.8174,7.8794,0
"201",1,19,16,-3,-14.620260630789,-2.1826,-1.1206,1
"202",1,17,21,4,-8.98747588861862,-9.1826,-6.1206,-1
"203",1,16,23,7,-6.27484262405635,-12.1826,-8.1206,-2
"204",1,21,22,1,-13.86863063484,-6.1826,-7.1206,3
"205",1,23,13,-10,-21.68925201149,4.8174,1.8794,5
"206",1,16,3,-13,-18.643337981083,7.8174,11.8794,-2
"207",1,19,7,-12,-20.1664662619185,6.8174,7.8794,1
"208",1,23,12,-11,-22.1615735441219,5.8174,2.8794,5
"209",1,14,12,-2,-10.411658349571,-3.1826,2.8794,-4
"210",1,23,1,-22,-28.6531827465863,16.8174,13.8794,5
"211",1,29,17,-12,-26.9169396907511,6.8174,-2.1206,11
"212",1,17,23,6,-7.75236779451094,-11.1826,-8.1206,-1
"213",1,12,9,-3,-9.91574984013355,-2.1826,5.8794,-6
"214",1,16,30,14,-2.26419489940319,-19.1826,-15.1206,-2
"215",1,20,0,-20,-25.7605830959415,14.8174,14.8794,2
"216",1,19,17,-2,-13.9917500004528,-3.1826,-2.1206,1
"217",1,17,20,3,-9.53968841408985,-8.1826,-5.1206,-1
"218",1,16,12,-4,-13.312137567116,-1.1826,2.8794,-2
"219",1,22,17,-5,-17.8915876705431,-0.1826,-2.1206,4
"220",1,22,1,-21,-27.5005546392096,15.8174,13.8794,4
"221",1,19,12,-7,-16.8534565329533,1.8174,2.8794,1
"222",1,20,20,0,-13.5082252493011,-5.1826,-5.1206,2
"223",1,18,23,5,-9.05601720206822,-10.1826,-8.1206,0
"224",1,27,23,-4,-20.5248115253415,-1.1826,-8.1206,9
"225",1,16,20,4,-8.18104682617491,-9.1826,-5.1206,-2
"226",1,20,1,-19,-24.9235576258527,13.8174,13.8794,2
"227",1,27,25,-2,-19.7180969772698,-3.1826,-10.1206,9
"228",1,27,21,-6,-21.5978931159068,0.8174,-6.1206,9
"229",1,20,2,-18,-24.22768345345,12.8174,12.8794,2
"230",1,16,19,3,-8.94040440556544,-8.1826,-4.1206,-2
"231",1,19,7,-12,-20.0833111904727,6.8174,7.8794,1
"232",1,28,29,1,-18.682095450596,-6.1826,-14.1206,10
"233",1,21,4,-17,-24.5817384581324,11.8174,10.8794,3
"234",1,23,23,0,-15.7063992730062,-5.1826,-8.1206,5
"235",1,20,16,-4,-15.5826680688423,-1.1826,-1.1206,2
"236",1,11,13,2,-5.44194226065162,-7.1826,1.8794,-7
"237",1,25,30,5,-13.9435447052554,-10.1826,-15.1206,7
"238",1,35,3,-32,-43.2789353292955,26.8174,11.8794,17
"239",1,20,25,5,-10.5210495058478,-10.1826,-10.1206,2
"240",1,23,16,-7,-20.0032721321193,1.8174,-1.1206,5
"241",1,21,8,-13,-21.9252060659138,7.8174,6.8794,3
"242",1,15,29,14,-1.47297002034565,-19.1826,-14.1206,-3
"243",1,21,26,5,-11.1180487796136,-10.1826,-11.1206,3
"244",1,18,30,12,-4.73028618576448,-17.1826,-15.1206,0
"245",1,15,17,2,-8.47253497765178,-7.1826,-2.1206,-3
"246",1,17,29,12,-4.07963062146031,-17.1826,-14.1206,-1
"247",1,19,24,5,-9.87709362584648,-10.1826,-9.1206,1
"248",1,21,24,3,-12.2932572168138,-8.1826,-9.1206,3
"249",1,23,14,-9,-21.1528939729743,3.8174,0.8794,5
"250",1,18,14,-4,-14.3196700013151,-1.1826,0.8794,0
"251",1,20,1,-19,-24.8948764399546,13.8174,13.8794,2
"252",1,27,6,-21,-30.8386028689937,15.8174,8.8794,9
"253",1,23,14,-9,-20.9915901304394,3.8174,0.8794,5
"254",1,24,29,5,-13.2100819312491,-10.1826,-14.1206,6
"255",1,21,23,2,-13.0244331322121,-7.1826,-8.1206,3
"256",1,10,17,7,-2.32530428541904,-12.1826,-2.1206,-8
"257",1,25,9,-16,-26.7724243341047,10.8174,5.8794,7
"258",1,12,3,-9,-13.2714648750689,3.8174,11.8794,-6
"259",1,12,28,16,1.5695216830514,-21.1826,-13.1206,-6
"260",1,23,2,-21,-28.2242749398353,15.8174,12.8794,5
"261",1,22,29,7,-10.7746027465352,-12.1826,-14.1206,4
"262",1,20,22,2,-12.2950599157228,-7.1826,-7.1206,2
"263",1,29,12,-17,-30.1972559391293,11.8174,2.8794,11
"264",1,23,20,-3,-17.3016882532884,-2.1826,-5.1206,5
"265",1,14,30,16,0.483628152190445,-21.1826,-15.1206,-4
"266",1,21,26,5,-11.503868757414,-10.1826,-11.1206,3
"267",1,29,21,-8,-24.6437227359336,2.8174,-6.1206,11
"268",1,21,19,-2,-15.1720740115221,-3.1826,-4.1206,3
"269",1,21,19,-2,-15.3185569385233,-3.1826,-4.1206,3
"270",1,25,27,2,-16.0524554839005,-7.1826,-12.1206,7
"271",1,17,28,11,-4.91941011871835,-16.1826,-13.1206,-1
"272",1,14,28,14,-1.07049459374777,-19.1826,-13.1206,-4
"273",1,25,12,-13,-24.8699958189137,7.8174,2.8794,7
"274",1,24,23,-1,-16.6338463238465,-4.1826,-8.1206,6
"275",1,17,16,-1,-11.7715921985239,-4.1826,-1.1206,-1
"276",1,19,0,-19,-24.0811998900623,13.8174,14.8794,1
"277",1,20,25,5,-10.5107587458009,-10.1826,-10.1206,2
"278",1,22,15,-7,-19.2027484528654,1.8174,-0.1206,4
"279",1,18,14,-4,-14.4073141971485,-1.1826,0.8794,0
"280",1,16,14,-2,-11.7949413781426,-3.1826,0.8794,-2
"281",1,19,29,10,-6.98703868548486,-15.1826,-14.1206,1
"282",1,10,19,9,-1.2761062531896,-14.1826,-4.1206,-8
"283",1,22,0,-22,-28.0335556137086,16.8174,14.8794,4
"284",1,26,0,-26,-33.3899094439229,20.8174,14.8794,8
"285",1,29,5,-24,-33.8532112796956,18.8174,9.8794,11
"286",1,23,24,1,-15.2014692109251,-6.1826,-9.1206,5
"287",1,21,28,7,-10.0692084286535,-12.1826,-13.1206,3
"288",1,24,1,-23,-29.9624632296457,17.8174,13.8794,6
"289",1,14,8,-6,-12.9167342380829,0.8174,6.8794,-4
"290",1,18,0,-18,-23.1696450502427,12.8174,14.8794,0
"291",1,26,10,-16,-27.1666948831819,10.8174,4.8794,8
"292",1,20,26,6,-9.88704062487984,-11.1826,-11.1206,2
"293",1,18,15,-3,-13.8408992135781,-2.1826,-0.1206,0
"294",1,16,6,-10,-16.430838409407,4.8174,8.8794,-2
"295",1,14,19,5,-6.27002367232517,-10.1826,-4.1206,-4
"296",1,22,0,-22,-27.9607752298628,16.8174,14.8794,4
"297",1,15,14,-1,-10.3257927832812,-4.1826,0.8794,-3
"298",1,18,11,-7,-15.9916451445204,1.8174,3.8794,0
"299",1,18,22,4,-9.40980007293842,-9.1826,-7.1206,0
"300",1,12,0,-12,-15.021722536386,6.8174,14.8794,-6
"301",1,22,13,-9,-20.3571746676704,3.8174,1.8794,4
"302",1,27,12,-15,-27.5424218456214,9.8174,2.8794,9
"303",1,13,24,11,-1.9795757551799,-16.1826,-9.1206,-5
"304",1,27,19,-8,-23.2832563075166,2.8174,-4.1206,9
"305",1,18,16,-2,-13.3027001877712,-3.1826,-1.1206,0
"306",1,23,1,-22,-28.8847351764123,16.8174,13.8794,5
"307",1,32,24,-8,-26.7034621794075,2.8174,-9.1206,14
"308",1,27,7,-20,-30.3849350151775,14.8174,7.8794,9
"309",1,16,21,5,-7.56690421549001,-10.1826,-6.1206,-2
"310",1,27,0,-27,-34.3362711423577,21.8174,14.8794,9
"311",1,19,3,-16,-22.4124990009388,10.8174,11.8794,1
"312",1,19,22,3,-10.994114325344,-8.1826,-7.1206,1
"313",1,27,24,-3,-20.1383876506147,-2.1826,-9.1206,9
"314",1,21,30,9,-8.65720921589636,-14.1826,-15.1206,3
"315",1,21,19,-2,-15.145870728504,-3.1826,-4.1206,3
"316",1,16,17,1,-9.91751431804784,-6.1826,-2.1206,-2
"317",1,18,19,1,-11.4054834544567,-6.1826,-4.1206,0
"318",1,28,13,-15,-27.9011538575845,9.8174,1.8794,10
"319",1,12,2,-10,-13.9642271488387,4.8174,12.8794,-6
"320",1,28,24,-4,-21.556846159592,-1.1826,-9.1206,10
"321",1,25,28,3,-15.1035590103219,-8.1826,-13.1206,7
"322",1,24,29,5,-13.3385251850268,-10.1826,-14.1206,6
"323",1,27,2,-25,-33.2544077811808,19.8174,12.8794,9
"324",1,14,12,-2,-10.6735688826075,-3.1826,2.8794,-4
"325",1,22,12,-10,-20.9723766533001,4.8174,2.8794,4
"326",1,21,19,-2,-15.456685156555,-3.1826,-4.1206,3
"327",1,19,18,-1,-13.3622880247028,-4.1826,-3.1206,1
"328",1,21,15,-6,-17.9825170943186,0.8174,-0.1206,3
"329",1,14,14,0,-9.25578118607509,-5.1826,0.8794,-4
"330",1,22,17,-5,-17.8281561209264,-0.1826,-2.1206,4
"331",1,21,4,-17,-24.4499781125915,11.8174,10.8794,3
"332",1,19,27,8,-8.09914656534581,-13.1826,-12.1206,1
"333",1,24,24,0,-16.4731897937418,-5.1826,-9.1206,6
"334",1,17,19,2,-10.0747485462694,-7.1826,-4.1206,-1
"335",1,15,16,1,-9.51370442046199,-6.1826,-1.1206,-3
"336",1,29,15,-14,-27.9658536806887,8.8174,-0.1206,11
"337",1,15,0,-15,-18.7092294517372,9.8174,14.8794,-3
"338",1,19,14,-5,-15.7645905513181,-0.1826,0.8794,1
"339",1,25,3,-22,-30.0121604925201,16.8174,11.8794,7
"340",1,25,13,-12,-24.2787734518049,6.8174,1.8794,7
"341",1,23,27,4,-12.7888479249476,-9.1826,-12.1206,5
"342",1,9,16,7,-1.3534744586615,-12.1826,-1.1206,-9
"343",1,22,6,-16,-24.6422508311928,10.8174,8.8794,4
"344",1,25,30,5,-13.9472539634918,-10.1826,-15.1206,7
"345",1,23,21,-2,-16.7329057965578,-3.1826,-6.1206,5
"346",1,23,24,1,-14.9630472286731,-6.1826,-9.1206,5
"347",1,17,2,-15,-20.2761566526161,9.8174,12.8794,-1
"348",1,17,29,12,-4.15096683718377,-17.1826,-14.1206,-1
"349",1,14,19,5,-6.15360775581249,-10.1826,-4.1206,-4
"350",1,15,7,-8,-14.919361706397,2.8174,7.8794,-3
"351",1,13,4,-9,-14.2261244329423,3.8174,10.8794,-5
"352",1,15,17,2,-8.61978069452332,-7.1826,-2.1206,-3
"353",1,14,2,-12,-16.4104676803574,6.8174,12.8794,-4
"354",1,20,9,-11,-20.2412622122969,5.8174,5.8794,2
"355",1,15,10,-5,-13.1131215995551,-0.1826,4.8794,-3
"356",1,27,22,-5,-21.4411575225318,-0.1826,-7.1206,9
"357",1,25,14,-11,-23.2439775447034,5.8174,0.8794,7
"358",1,25,30,5,-14.1203298033894,-10.1826,-15.1206,7
"359",1,14,28,14,-0.931351572442651,-19.1826,-13.1206,-4
"360",1,23,7,-16,-25.140585216399,10.8174,7.8794,5
"361",1,19,10,-9,-18.1754154663629,3.8174,4.8794,1
"362",1,20,9,-11,-20.217132965497,5.8174,5.8794,2
"363",1,22,25,3,-13.2421222281061,-8.1826,-10.1206,4
"364",1,17,19,2,-10.3472925002162,-7.1826,-4.1206,-1
"365",1,24,4,-20,-28.35142842278,14.8174,10.8794,6
"366",1,19,7,-12,-19.937195198318,6.8174,7.8794,1
"367",1,18,17,-1,-12.3891645120607,-4.1826,-2.1206,0
"368",1,23,27,4,-13.3474565217514,-9.1826,-12.1206,5
"369",1,13,24,11,-1.80195790857,-16.1826,-9.1206,-5
"370",1,19,11,-8,-17.3838175467461,2.8174,3.8794,1
"371",1,18,30,12,-4.99892743759618,-17.1826,-15.1206,0
"372",1,20,19,-1,-14.0710340039316,-4.1826,-4.1206,2
"373",1,20,8,-12,-20.7455896004421,6.8174,6.8794,2
"374",1,13,25,12,-1.4619331013462,-17.1826,-10.1206,-5
"375",1,20,21,1,-12.727997127215,-6.1826,-6.1206,2
"376",1,22,19,-3,-16.5154987966135,-2.1826,-4.1206,4
"377",1,21,26,5,-11.272204646668,-10.1826,-11.1206,3
"378",1,16,27,11,-3.937350947067,-16.1826,-12.1206,-2
"379",1,23,17,-6,-19.1839930960163,0.8174,-2.1206,5
"380",1,16,11,-5,-13.4506012258068,-0.1826,3.8794,-2
"381",1,17,18,1,-10.8563444830665,-6.1826,-3.1206,-1
"382",1,25,7,-18,-27.8555575243155,12.8174,7.8794,7
"383",1,23,25,2,-14.5597887997248,-7.1826,-10.1206,5
"384",1,20,1,-19,-24.581611634045,13.8174,13.8794,2
"385",1,20,14,-6,-17.0719582297307,0.8174,0.8794,2
"386",1,32,0,-32,-40.9259241517938,26.8174,14.8794,14
"387",1,24,7,-17,-26.5074016806447,11.8174,7.8794,6
"388",1,15,15,0,-9.97005557774964,-5.1826,-0.1206,-3
"389",1,22,12,-10,-20.8352980711405,4.8174,2.8794,4
"390",1,21,28,7,-10.0341546462799,-12.1826,-13.1206,3
"391",1,28,23,-5,-21.94950608817,-0.1826,-8.1206,10
"392",1,17,10,-7,-15.5029083162249,1.8174,4.8794,-1
"393",1,25,18,-7,-21.2604484004492,1.8174,-3.1206,7
"394",1,16,6,-10,-16.5324922739396,4.8174,8.8794,-2
"395",1,29,1,-28,-36.7653939343502,22.8174,13.8794,11
"396",1,19,18,-1,-13.4072231299013,-4.1826,-3.1206,1
"397",1,29,27,-2,-21.0887053678436,-3.1826,-12.1206,11
"398",1,18,27,9,-6.98554333124415,-14.1826,-12.1206,0
"399",1,19,23,4,-10.779080259761,-9.1826,-8.1206,1
"400",1,26,24,-2,-18.9137620214196,-3.1826,-9.1206,8
"401",1,26,15,-11,-23.9741934893928,5.8174,-0.1206,8
"402",1,22,21,-1,-15.1413054013987,-4.1826,-6.1206,4
"403",1,15,9,-6,-13.9083734949231,0.8174,5.8794,-3
"404",1,23,4,-19,-27.2005181423448,13.8174,10.8794,5
"405",1,21,29,8,-9.51766364351299,-13.1826,-14.1206,3
"406",1,22,5,-17,-25.0677503761176,11.8174,9.8794,4
"407",1,14,9,-5,-12.5264400858834,-0.1826,5.8794,-4
"408",1,18,12,-6,-15.6059101212288,0.8174,2.8794,0
"409",1,17,17,0,-11.6020696895265,-5.1826,-2.1206,-1
"410",1,13,7,-6,-11.97464059166,0.8174,7.8794,-5
"411",1,21,6,-15,-23.2620304386249,9.8174,8.8794,3
"412",1,23,21,-2,-16.8950997402624,-3.1826,-6.1206,5
"413",1,24,4,-20,-28.3099324740888,14.8174,10.8794,6
"414",1,22,9,-13,-22.76146082365,7.8174,5.8794,4
"415",1,19,18,-1,-13.3247785210743,-4.1826,-3.1206,1
"416",1,21,25,4,-11.865582740994,-9.1826,-10.1206,3
"417",1,22,1,-21,-27.4161929439825,15.8174,13.8794,4
"418",1,23,16,-7,-19.731640223005,1.8174,-1.1206,5
"419",1,19,11,-8,-17.8883570795821,2.8174,3.8794,1
"420",1,20,28,8,-8.98444854984571,-13.1826,-13.1206,2
"421",1,17,25,8,-6.35260009620805,-13.1826,-10.1206,-1
"422",1,18,17,-1,-12.9159131018961,-4.1826,-2.1206,0
"423",1,17,23,6,-7.74719998161983,-11.1826,-8.1206,-1
"424",1,19,19,0,-12.901299816972,-5.1826,-4.1206,1
"425",1,16,28,12,-3.46586221983626,-17.1826,-13.1206,-2
"426",1,20,0,-20,-25.3257501232301,14.8174,14.8794,2
"427",1,21,15,-6,-17.669811327915,0.8174,-0.1206,3
"428",1,20,1,-19,-24.8666981687766,13.8174,13.8794,2
"429",1,18,29,11,-5.49923144582285,-16.1826,-14.1206,0
"430",1,24,8,-16,-25.9896854543498,10.8174,6.8794,6
"431",1,23,15,-8,-20.4675717318975,2.8174,-0.1206,5
"432",1,18,29,11,-5.56923661274285,-16.1826,-14.1206,0
"433",1,14,25,11,-2.53680982337949,-16.1826,-10.1206,-4
"434",1,22,25,3,-12.9202802291672,-8.1826,-10.1206,4
"435",1,23,15,-8,-20.1760633830052,2.8174,-0.1206,5
"436",1,13,17,4,-5.99642508667364,-9.1826,-2.1206,-5
"437",1,21,12,-9,-19.7858651392077,3.8174,2.8794,3
"438",1,27,27,0,-18.2514746668301,-5.1826,-12.1206,9
"439",1,10,24,14,1.52593590299799,-19.1826,-9.1206,-8
"440",1,11,16,5,-3.99386223281208,-10.1826,-1.1206,-7
"441",1,25,18,-7,-21.3295775896511,1.8174,-3.1206,7
"442",1,20,3,-17,-23.7100811045186,11.8174,11.8794,2
"443",1,22,16,-6,-18.544708753761,0.8174,-1.1206,4
"444",1,17,22,5,-8.24946400950154,-10.1826,-7.1206,-1
"445",1,19,8,-11,-19.1482184682491,5.8174,6.8794,1
"446",1,31,0,-31,-40.1782177370139,25.8174,14.8794,13
"447",1,17,30,13,-3.46298575606278,-18.1826,-15.1206,-1
"448",1,23,11,-12,-22.8987445578812,6.8174,3.8794,5
"449",1,13,23,10,-2.3951280500245,-15.1826,-8.1206,-5
"450",1,20,5,-15,-22.4800796874128,9.8174,9.8794,2
"451",1,15,0,-15,-18.7890055060029,9.8174,14.8794,-3
"452",1,15,9,-6,-13.5443516865501,0.8174,5.8794,-3
"453",1,22,1,-21,-27.27038879044,15.8174,13.8794,4
"454",1,28,4,-24,-33.4136617579982,18.8174,10.8794,10
"455",1,14,16,2,-8.21733810786549,-7.1826,-1.1206,-4
"456",1,23,27,4,-13.2501672336088,-9.1826,-12.1206,5
"457",1,20,12,-8,-18.4632835926287,2.8174,2.8794,2
"458",1,13,2,-11,-15.1579562709172,5.8174,12.8794,-5
"459",1,25,28,3,-15.3573428578927,-8.1826,-13.1206,7
"460",1,25,29,4,-14.8048355807095,-9.1826,-14.1206,7
"461",1,28,30,2,-18.0537452711063,-7.1826,-15.1206,10
"462",1,15,13,-2,-11.3052256488477,-3.1826,1.8794,-3
"463",1,14,0,-14,-17.5462249687996,8.8174,14.8794,-4
"464",1,27,9,-18,-29.2350457058115,12.8174,5.8794,9
"465",1,19,24,5,-9.66141323020062,-10.1826,-9.1206,1
"466",1,15,15,0,-9.96986068832727,-5.1826,-0.1206,-3
"467",1,18,24,6,-8.520435495477,-11.1826,-9.1206,0
"468",1,7,17,10,2.01052203865456,-15.1826,-2.1206,-11
"469",1,24,30,6,-12.8521446179461,-11.1826,-15.1206,6
"470",1,23,7,-16,-25.0992619340881,10.8174,7.8794,5
"471",1,11,6,-5,-10.22185695606,-0.1826,8.8794,-7
"472",1,27,16,-11,-25.1311823319559,5.8174,-1.1206,9
"473",1,19,9,-10,-18.8916181448565,4.8174,5.8794,1
"474",1,19,30,11,-6.22615491233365,-16.1826,-15.1206,1
"475",1,18,20,2,-10.683511609285,-7.1826,-5.1206,0
"476",1,18,0,-18,-22.8764984124801,12.8174,14.8794,0
"477",1,19,20,1,-12.0240786691051,-6.1826,-5.1206,1
"478",1,29,17,-12,-27.1541278655938,6.8174,-2.1206,11
"479",1,14,22,8,-4.42267053368875,-13.1826,-7.1206,-4
"480",1,22,26,4,-12.6655847795008,-9.1826,-11.1206,4
"481",1,28,10,-18,-30.0697639381053,12.8174,4.8794,10
"482",1,18,12,-6,-15.7280363358809,0.8174,2.8794,0
"483",1,16,17,1,-10.1786576587103,-6.1826,-2.1206,-2
"484",1,12,13,1,-7.24049763703147,-6.1826,1.8794,-6
"485",1,15,4,-11,-16.6769607265729,5.8174,10.8794,-3
"486",1,23,11,-12,-23.0790612811002,6.8174,3.8794,5
"487",1,18,28,10,-6.1160773969261,-15.1826,-13.1206,0
"488",1,23,2,-21,-28.3293926727074,15.8174,12.8794,5
"489",1,22,16,-6,-18.4355221157464,0.8174,-1.1206,4
"490",1,13,17,4,-6.00838745751948,-9.1826,-2.1206,-5
"491",1,27,26,-1,-19.2660769550518,-4.1826,-11.1206,9
"492",1,24,8,-16,-25.9205317145662,10.8174,6.8794,6
"493",1,20,5,-15,-22.2783534259261,9.8174,9.8794,2
"494",1,20,10,-10,-19.4425117587941,4.8174,4.8794,2
"495",1,11,12,1,-6.69853386183338,-6.1826,2.8794,-7
"496",1,24,14,-10,-22.3506057263948,4.8174,0.8794,6
"497",1,21,1,-20,-26.0718875373363,14.8174,13.8794,3
"498",1,14,20,6,-5.65729434220676,-11.1826,-5.1206,-4
"499",1,25,1,-24,-31.2961871877342,18.8174,13.8794,7
"500",1,21,4,-17,-24.3193034713817,11.8174,10.8794,3
"501",1,15,2,-13,-18.0913786161507,7.8174,12.8794,-3
"502",1,15,4,-11,-16.7154284175955,5.8174,10.8794,-3
"503",1,14,27,13,-1.60956756286067,-18.1826,-12.1206,-4
"504",1,20,23,3,-11.6121241418211,-8.1826,-8.1206,2
"505",1,21,27,6,-10.3538327857757,-11.1826,-12.1206,3
"506",1,16,8,-8,-15.5183025205587,2.8174,6.8794,-2
"507",1,22,9,-13,-22.5813295038919,7.8174,5.8794,4
"508",1,13,25,12,-1.55753056464369,-17.1826,-10.1206,-5
"509",1,17,6,-11,-17.8155217513632,5.8174,8.8794,-1
"510",1,24,13,-11,-23.0989597202913,5.8174,1.8794,6
"511",1,20,1,-19,-24.7386261414177,13.8174,13.8794,2
"512",1,22,18,-4,-17.21003030951,-1.1826,-3.1206,4
"513",1,19,17,-2,-14.1623910584225,-3.1826,-2.1206,1
"514",1,12,6,-6,-11.5489351883298,0.8174,8.8794,-6
"515",1,19,21,2,-11.7176168223715,-7.1826,-6.1206,1
"516",1,17,19,2,-10.1281320828615,-7.1826,-4.1206,-1
"517",1,15,0,-15,-19.2738193140117,9.8174,14.8794,-3
"518",1,20,29,9,-8.2970182869738,-14.1826,-14.1206,2
"519",1,19,27,8,-8.22449925732308,-13.1826,-12.1206,1
"520",1,26,18,-8,-22.3177322998143,2.8174,-3.1206,8
"521",1,14,13,-1,-9.83041413681756,-4.1826,1.8794,-4
"522",1,18,2,-16,-21.4794934654373,10.8174,12.8794,0
"523",1,22,11,-11,-21.5579122963932,5.8174,3.8794,4
"524",1,19,4,-15,-21.8623093231575,9.8174,10.8794,1
"525",1,19,9,-10,-18.9483357226281,4.8174,5.8794,1
"526",1,15,6,-9,-15.3772918434822,3.8174,8.8794,-3
"527",1,20,20,0,-13.6886377436361,-5.1826,-5.1206,2
"528",1,22,5,-17,-25.0726951044511,11.8174,9.8794,4
"529",1,21,1,-20,-26.3593704728342,14.8174,13.8794,3
"530",1,21,3,-18,-25.0477470724243,12.8174,11.8794,3
"531",1,23,26,3,-13.7259645703535,-8.1826,-11.1206,5
"532",1,30,26,-4,-22.7024909124084,-1.1826,-11.1206,12
"533",1,24,16,-8,-21.0926232668369,2.8174,-1.1206,6
"534",1,18,2,-16,-21.7491846441771,10.8174,12.8794,0
"535",1,25,9,-16,-26.6880743303719,10.8174,5.8794,7
"536",1,18,6,-12,-19.3152604035381,6.8174,8.8794,0
"537",1,22,2,-20,-26.8251552235705,14.8174,12.8794,4
"538",1,15,14,-1,-10.5988679209587,-4.1826,0.8794,-3
"539",1,22,2,-20,-26.771445498096,14.8174,12.8794,4
"540",1,12,21,9,-2.40009447897999,-14.1826,-6.1206,-6
"541",1,21,16,-5,-17.3432635249364,-0.1826,-1.1206,3
"542",1,16,5,-11,-17.2961231660816,5.8174,9.8794,-2
"543",1,25,1,-24,-31.3945846990131,18.8174,13.8794,7
"544",1,20,25,5,-10.6009083172023,-10.1826,-10.1206,2
"545",1,26,10,-16,-27.1707177432261,10.8174,4.8794,8
"546",1,16,20,4,-8.29233324731492,-9.1826,-5.1206,-2
"547",1,19,6,-13,-20.7844006380652,7.8174,8.8794,1
"548",1,22,4,-18,-25.6841785257461,12.8174,10.8794,4
"549",1,22,0,-22,-27.7712092380887,16.8174,14.8794,4
"550",1,20,28,8,-8.82974992113139,-13.1826,-13.1206,2
"551",1,17,7,-10,-17.0507416509818,4.8174,7.8794,-1
"552",1,19,15,-4,-14.9534353287302,-1.1826,-0.1206,1
"553",1,10,18,8,-1.48459856118323,-13.1826,-3.1206,-8
"554",1,9,23,14,2.63684105149291,-19.1826,-8.1206,-9
"555",1,19,18,-1,-13.3148012646036,-4.1826,-3.1206,1
"556",1,13,25,12,-1.46580190129675,-17.1826,-10.1206,-5
"557",1,21,25,4,-12.1497364576454,-9.1826,-10.1206,3
"558",1,24,10,-14,-24.5367540453031,8.8174,4.8794,6
"559",1,19,13,-6,-16.4619797435578,0.8174,1.8794,1
"560",1,15,21,6,-6.50522995859797,-11.1826,-6.1206,-3
"561",1,24,9,-15,-25.3695605585722,9.8174,5.8794,6
"562",1,24,5,-19,-27.4039565671773,13.8174,9.8794,6
"563",1,27,27,0,-18.3135520935486,-5.1826,-12.1206,9
"564",1,11,15,4,-4.82520257967522,-9.1826,-0.1206,-7
"565",1,22,26,4,-12.5236553879438,-9.1826,-11.1206,4
"566",1,25,9,-16,-26.5333555881025,10.8174,5.8794,7
"567",1,18,9,-9,-17.3239709714901,3.8174,5.8794,0
"568",1,30,24,-6,-24.1509279724778,0.8174,-9.1206,12
"569",1,17,8,-9,-16.5747835485166,3.8174,6.8794,-1
"570",1,20,13,-7,-17.5802999342002,1.8174,1.8794,2
"571",1,15,6,-9,-15.5214084624179,3.8174,8.8794,-3
"572",1,15,27,12,-2.82596852611675,-17.1826,-12.1206,-3
"573",1,21,26,5,-11.0719207251207,-10.1826,-11.1206,3
"574",1,20,4,-16,-22.8863880973495,10.8174,10.8794,2
"575",1,14,9,-5,-12.47164193972,-0.1826,5.8794,-4
"576",1,24,8,-16,-25.8689785845282,10.8174,6.8794,6
"577",1,20,0,-20,-25.4589291590072,14.8174,14.8794,2
"578",1,27,11,-16,-27.7318618112499,10.8174,3.8794,9
"579",1,14,0,-14,-17.4769218082017,8.8174,14.8794,-4
"580",1,13,21,8,-3.64047133831115,-13.1826,-6.1206,-5
"581",1,21,24,3,-12.4886228156767,-8.1826,-9.1206,3
"582",1,25,30,5,-14.0306174068378,-10.1826,-15.1206,7
"583",1,23,4,-19,-27.1742492088336,13.8174,10.8794,5
"584",1,17,8,-9,-17.0005250755979,3.8174,6.8794,-1
"585",1,21,18,-3,-15.8518062807514,-2.1826,-3.1206,3
"586",1,29,30,1,-19.0481479089063,-6.1826,-15.1206,11
"587",1,27,22,-5,-21.4458988470946,-0.1826,-7.1206,9
"588",1,20,7,-13,-21.4405439725919,7.8174,7.8794,2
"589",1,16,20,4,-8.25177784162839,-9.1826,-5.1206,-2
"590",1,23,0,-23,-29.4371760391928,17.8174,14.8794,5
"591",1,24,16,-8,-20.8453387947741,2.8174,-1.1206,6
"592",1,20,25,5,-10.5220401435966,-10.1826,-10.1206,2
"593",1,23,20,-3,-17.327919379087,-2.1826,-5.1206,5
"594",1,23,5,-18,-26.2243702446784,12.8174,9.8794,5
"595",1,25,2,-23,-30.5061273178608,17.8174,12.8794,7
"596",1,31,3,-28,-37.7625997288938,22.8174,11.8794,13
"597",1,16,5,-11,-17.4169368960688,5.8174,9.8794,-2
"598",1,17,17,0,-11.3094628542616,-5.1826,-2.1206,-1
"599",1,19,27,8,-7.89383010130224,-13.1826,-12.1206,1
"600",1,23,18,-5,-18.4902607109887,-0.1826,-3.1206,5
"601",1,20,15,-5,-16.7622640173524,-0.1826,-0.1206,2
"602",1,22,12,-10,-20.7633840913978,4.8174,2.8794,4
"603",1,11,21,10,-1.1866394652112,-15.1826,-6.1206,-7
"604",1,24,15,-9,-21.6924122287645,3.8174,-0.1206,6
"605",1,26,14,-12,-24.8812249439257,6.8174,0.8794,8
"606",1,22,27,5,-11.9285811698195,-10.1826,-12.1206,4
"607",1,9,24,15,3.06465662903556,-20.1826,-9.1206,-9
"608",1,26,8,-18,-28.4230579037799,12.8174,6.8794,8
"609",1,20,14,-6,-17.3368213990251,0.8174,0.8794,2
"610",1,20,15,-5,-16.4860447922776,-0.1826,-0.1206,2
"611",1,18,23,5,-8.95678092300808,-10.1826,-8.1206,0
"612",1,17,27,10,-5.4379654721405,-15.1826,-12.1206,-1
"613",1,21,1,-20,-26.2384828321708,14.8174,13.8794,3
"614",1,27,17,-10,-24.4722263019569,4.8174,-2.1206,9
"615",1,19,15,-4,-15.185308504729,-1.1826,-0.1206,1
"616",1,25,27,2,-15.9637546029767,-7.1826,-12.1206,7
"617",1,14,29,15,-0.218487438538993,-20.1826,-14.1206,-4
"618",1,19,2,-17,-22.8458754384622,11.8174,12.8794,1
"619",1,25,3,-22,-30.177212123054,16.8174,11.8794,7
"620",1,19,30,11,-6.65617286537173,-16.1826,-15.1206,1
"621",1,22,6,-16,-24.2824199560305,10.8174,8.8794,4
"622",1,22,20,-2,-16.0662652580773,-3.1826,-5.1206,4
"623",1,16,12,-4,-13.0455048567288,-1.1826,2.8794,-2
"624",1,19,29,10,-6.47307773025967,-15.1826,-14.1206,1
"625",1,26,6,-20,-29.5943122421196,14.8174,8.8794,8
"626",1,25,16,-9,-22.3346079225397,3.8174,-1.1206,7
"627",1,20,12,-8,-18.2216644219024,2.8174,2.8794,2
"628",1,18,23,5,-9.25204378683939,-10.1826,-8.1206,0
"629",1,20,26,6,-9.86782439428074,-11.1826,-11.1206,2
"630",1,19,21,2,-11.5351337130579,-7.1826,-6.1206,1
"631",1,10,20,10,-0.118899806221385,-15.1826,-5.1206,-8
"632",1,26,27,1,-17.2677867274262,-6.1826,-12.1206,8
"633",1,21,3,-18,-25.2110390655516,12.8174,11.8794,3
"634",1,26,6,-20,-29.9309638739586,14.8174,8.8794,8
"635",1,18,29,11,-5.87425172701434,-16.1826,-14.1206,0
"636",1,21,22,1,-13.6821465585142,-6.1826,-7.1206,3
"637",1,20,16,-4,-15.8706997474063,-1.1826,-1.1206,2
"638",1,14,20,6,-5.65503256525942,-11.1826,-5.1206,-4
"639",1,23,18,-5,-18.5556940099811,-0.1826,-3.1206,5
"640",1,22,29,7,-10.8930756901427,-12.1826,-14.1206,4
"641",1,27,26,-1,-18.7192841740203,-4.1826,-11.1206,9
"642",1,16,14,-2,-11.764831911678,-3.1826,0.8794,-2
"643",1,22,10,-12,-22.024168239,6.8174,4.8794,4
"644",1,20,17,-3,-15.2193973472048,-2.1826,-2.1206,2
"645",1,15,1,-14,-18.0749453970025,8.8174,13.8794,-3
"646",1,24,7,-17,-26.3936601890123,11.8174,7.8794,6
"647",1,23,10,-13,-23.5192384805328,7.8174,4.8794,5
"648",1,21,7,-14,-22.4863094351327,8.8174,7.8794,3
"649",1,19,12,-7,-17.0550725929934,1.8174,2.8794,1
"650",1,19,4,-15,-21.7671923323232,9.8174,10.8794,1
"651",1,14,26,12,-2.12791169531468,-17.1826,-11.1206,-4
"652",1,17,19,2,-10.411146249142,-7.1826,-4.1206,-1
"653",1,22,10,-12,-22.3570225636055,6.8174,4.8794,4
"654",1,23,7,-16,-25.3681581129878,10.8174,7.8794,5
"655",1,21,13,-8,-18.7633123548258,2.8174,1.8794,3
"656",1,23,14,-9,-20.9852772415411,3.8174,0.8794,5
"657",1,22,26,4,-12.4672197683371,-9.1826,-11.1206,4
"658",1,19,29,10,-6.84667647064444,-15.1826,-14.1206,1
"659",1,24,26,2,-15.4600585517395,-7.1826,-11.1206,6
"660",1,19,18,-1,-13.3873815494548,-4.1826,-3.1206,1
"661",1,22,7,-15,-24.003995598837,9.8174,7.8794,4
"662",1,19,8,-11,-19.5500585440773,5.8174,6.8794,1
"663",1,19,9,-10,-18.9820909446272,4.8174,5.8794,1
"664",1,29,14,-15,-28.6902169621412,9.8174,0.8794,11
"665",1,17,7,-10,-17.6230024371384,4.8174,7.8794,-1
"666",1,18,3,-15,-21.2329892154663,9.8174,11.8794,0
"667",1,19,23,4,-10.3562790720433,-9.1826,-8.1206,1
"668",1,18,27,9,-6.98433392616368,-14.1826,-12.1206,0
"669",1,21,20,-1,-14.7455356038078,-4.1826,-5.1206,3
"670",1,24,20,-4,-18.8025843639386,-1.1826,-5.1206,6
"671",1,29,20,-9,-25.4007071900771,3.8174,-5.1206,11
"672",1,31,11,-20,-33.2380394214169,14.8174,3.8794,13
"673",1,18,15,-3,-13.8723180704398,-2.1826,-0.1206,0
"674",1,18,27,9,-6.71144846752771,-14.1826,-12.1206,0
"675",1,17,28,11,-4.73729140600732,-16.1826,-13.1206,-1
"676",1,13,24,11,-1.83880307509104,-16.1826,-9.1206,-5
"677",1,25,12,-13,-24.5229661920842,7.8174,2.8794,7
"678",1,12,15,3,-6.03768543304066,-8.1826,-0.1206,-6
"679",1,28,26,-2,-20.627045814074,-3.1826,-11.1206,10
"680",1,23,1,-22,-28.7737671777234,16.8174,13.8794,5
"681",1,20,2,-18,-24.3777095706367,12.8174,12.8794,2
"682",1,23,18,-5,-18.7089394199783,-0.1826,-3.1206,5
"683",1,24,21,-3,-18.0656150361161,-2.1826,-6.1206,6
"684",1,12,27,15,1.0984354282877,-20.1826,-12.1206,-6
"685",1,14,4,-10,-15.4369778766565,4.8174,10.8794,-4
"686",1,23,11,-12,-22.7306412705582,6.8174,3.8794,5
"687",1,16,24,8,-5.78544680754997,-13.1826,-9.1206,-2
"688",1,25,11,-14,-25.3689929329072,8.8174,3.8794,7
"689",1,17,22,5,-8.3325203937811,-10.1826,-7.1206,-1
"690",1,25,1,-24,-31.4977272932056,18.8174,13.8794,7
"691",1,22,7,-15,-23.6593919509236,9.8174,7.8794,4
"692",1,16,27,11,-3.6603199445408,-16.1826,-12.1206,-2
"693",1,22,12,-10,-20.6720866749771,4.8174,2.8794,4
"694",1,15,26,11,-3.29058760111668,-16.1826,-11.1206,-3
"695",1,15,7,-8,-14.7964110388951,2.8174,7.8794,-3
"696",1,22,20,-2,-16.2940605390926,-3.1826,-5.1206,4
"697",1,20,16,-4,-15.8032183356239,-1.1826,-1.1206,2
"698",1,17,28,11,-5.07474391305155,-16.1826,-13.1206,-1
"699",1,22,5,-17,-25.178296501897,11.8174,9.8794,4
"700",1,19,3,-16,-22.7385930233263,10.8174,11.8794,1
"701",1,16,11,-5,-13.7067550862642,-0.1826,3.8794,-2
"702",1,18,0,-18,-22.7700352341594,12.8174,14.8794,0
"703",1,23,2,-21,-28.4170339692379,15.8174,12.8794,5
"704",1,17,1,-16,-21.2028052295419,10.8174,13.8794,-1
"705",1,23,14,-9,-21.1074757902535,3.8174,0.8794,5
"706",1,20,12,-8,-18.3468757324618,2.8174,2.8794,2
"707",1,26,2,-24,-32.1068208561165,18.8174,12.8794,8
"708",1,25,22,-3,-18.8110927802218,-2.1826,-7.1206,7
"709",1,16,12,-4,-13.239860056339,-1.1826,2.8794,-2
"710",1,22,21,-1,-15.6414597424798,-4.1826,-6.1206,4
"711",1,16,5,-11,-17.0413340296966,5.8174,9.8794,-2
"712",1,17,8,-9,-16.7040802233226,3.8174,6.8794,-1
"713",1,18,27,9,-6.59697148279083,-14.1826,-12.1206,0
"714",1,17,21,4,-9.06453380689,-9.1826,-6.1206,-1
"715",1,20,9,-11,-19.9718127096518,5.8174,5.8794,2
"716",1,15,7,-8,-14.7631544413022,2.8174,7.8794,-3
"717",1,16,14,-2,-12.0902303018546,-3.1826,0.8794,-2
"718",1,24,10,-14,-24.6577281469808,8.8174,4.8794,6
"719",1,23,5,-18,-26.4932663710698,12.8174,9.8794,5
"720",1,21,13,-8,-18.7964666571107,2.8174,1.8794,3
"721",1,14,8,-6,-12.5142193394451,0.8174,6.8794,-4
"722",1,23,9,-14,-23.9506477577299,8.8174,5.8794,5
"723",1,21,27,6,-10.6119971268736,-11.1826,-12.1206,3
"724",1,21,23,2,-13.0156300499178,-7.1826,-8.1206,3
"725",1,23,1,-22,-28.8631596084835,16.8174,13.8794,5
"726",1,27,30,3,-16.4346703937199,-8.1826,-15.1206,9
"727",1,23,1,-22,-28.7167888631809,16.8174,13.8794,5
"728",1,21,14,-7,-18.3753188893086,1.8174,0.8794,3
"729",1,24,28,4,-14.0448075761274,-9.1826,-13.1206,6
"730",1,28,0,-28,-35.6513298888601,22.8174,14.8794,10
"731",1,20,13,-7,-17.6755047357972,1.8174,1.8794,2
"732",1,21,15,-6,-17.9850640461512,0.8174,-0.1206,3
"733",1,20,0,-20,-25.628285035837,14.8174,14.8794,2
"734",1,16,11,-5,-13.9857357740391,-0.1826,3.8794,-2
"735",1,25,28,3,-14.9489363716605,-8.1826,-13.1206,7
"736",1,14,24,10,-3.17473460899827,-15.1826,-9.1206,-4
"737",1,18,6,-12,-19.3387048286738,6.8174,8.8794,0
"738",1,21,22,1,-13.6081022781464,-6.1826,-7.1206,3
"739",1,14,20,6,-5.62112586259041,-11.1826,-5.1206,-4
"740",1,23,26,3,-13.9382251137071,-8.1826,-11.1206,5
"741",1,16,16,0,-10.5309338719464,-5.1826,-1.1206,-2
"742",1,21,20,-1,-14.8945971583566,-4.1826,-5.1206,3
"743",1,11,30,19,4.20909029250717,-24.1826,-15.1206,-7
"744",1,13,19,6,-4.93285949026531,-11.1826,-4.1206,-5
"745",1,16,4,-12,-17.9242714529389,6.8174,10.8794,-2
"746",1,20,7,-13,-21.3542319088882,7.8174,7.8794,2
"747",1,31,19,-12,-28.4739436149637,6.8174,-4.1206,13
"748",1,18,11,-7,-16.2479116552154,1.8174,3.8794,0
"749",1,18,25,7,-7.91428852975133,-12.1826,-10.1206,0
"750",1,14,23,9,-3.93019015454132,-14.1826,-8.1206,-4
"751",1,17,17,0,-11.4792603022501,-5.1826,-2.1206,-1
"752",1,18,1,-17,-22.4519491528568,11.8174,13.8794,0
"753",1,24,1,-23,-29.86722313461,17.8174,13.8794,6
"754",1,23,24,1,-14.8003420297374,-6.1826,-9.1206,5
"755",1,18,8,-10,-18.173498674653,4.8174,6.8794,0
"756",1,21,10,-11,-20.5608222572737,5.8174,4.8794,3
"757",1,22,9,-13,-22.6888139222088,7.8174,5.8794,4
"758",1,21,10,-11,-20.9783309535661,5.8174,4.8794,3
"759",1,24,7,-17,-26.658383337401,11.8174,7.8794,6
"760",1,12,29,17,2.43601161115019,-22.1826,-14.1206,-6
"761",1,17,24,7,-7.2922535592963,-12.1826,-9.1206,-1
"762",1,13,2,-11,-15.0793664358846,5.8174,12.8794,-5
"763",1,24,18,-6,-19.8000158970959,0.8174,-3.1206,6
"764",1,22,17,-5,-17.6796290982836,-0.1826,-2.1206,4
"765",1,21,9,-12,-21.4315423344681,6.8174,5.8794,3
"766",1,24,12,-12,-23.5587892562135,6.8174,2.8794,6
"767",1,23,7,-16,-25.2585746280542,10.8174,7.8794,5
"768",1,16,5,-11,-17.5180696689076,5.8174,9.8794,-2
"769",1,20,21,1,-13.1150157994932,-6.1826,-6.1206,2
"770",1,31,18,-13,-29.0726859194316,7.8174,-3.1206,13
"771",1,22,13,-9,-20.1782069313129,3.8174,1.8794,4
"772",1,21,5,-16,-23.6902851779561,10.8174,9.8794,3
"773",1,17,26,9,-6.00390919014068,-14.1826,-11.1206,-1
"774",1,23,4,-19,-26.8968199255787,13.8174,10.8794,5
"775",1,16,15,-1,-11.2108111857202,-4.1826,-0.1206,-2
"776",1,14,25,11,-2.8708428930511,-16.1826,-10.1206,-4
"777",1,21,15,-6,-17.7598006277901,0.8174,-0.1206,3
"778",1,19,21,2,-11.3901420858298,-7.1826,-6.1206,1
"779",1,23,6,-17,-25.5515460136357,11.8174,8.8794,5
"780",1,18,20,2,-10.7542855759505,-7.1826,-5.1206,0
"781",1,23,21,-2,-16.8188832859995,-3.1826,-6.1206,5
"782",1,12,10,-2,-9.31346107588785,-3.1826,4.8794,-6
"783",1,16,23,7,-6.40156611889494,-12.1826,-8.1206,-2
"784",1,11,18,7,-3.08731338526583,-12.1826,-3.1206,-7
"785",1,14,13,-1,-9.96460299961757,-4.1826,1.8794,-4
"786",1,16,15,-1,-11.0376107028895,-4.1826,-0.1206,-2
"787",1,19,24,5,-9.90515468898375,-10.1826,-9.1206,1
"788",1,23,27,4,-13.1160584025949,-9.1826,-12.1206,5
"789",1,22,4,-18,-25.5520210512454,12.8174,10.8794,4
"790",1,23,15,-8,-20.3447168574368,2.8174,-0.1206,5
"791",1,20,21,1,-13.1136408990063,-6.1826,-6.1206,2
"792",1,23,19,-4,-17.9278522696812,-1.1826,-4.1206,5
"793",1,16,22,6,-6.70078788319457,-11.1826,-7.1206,-2
"794",1,21,18,-3,-15.9997366742369,-2.1826,-3.1206,3
"795",1,21,2,-19,-25.3355134977047,13.8174,12.8794,3
"796",1,19,13,-6,-16.3849096837025,0.8174,1.8794,1
"797",1,18,4,-14,-20.5840064031262,8.8174,10.8794,0
"798",1,23,30,7,-11.3013472888951,-12.1826,-15.1206,5
"799",1,22,15,-7,-18.9711812302662,1.8174,-0.1206,4
"800",1,22,29,7,-10.8673865357356,-12.1826,-14.1206,4
"801",1,22,10,-12,-22.1195101495291,6.8174,4.8794,4
"802",1,19,9,-10,-18.7854720203191,4.8174,5.8794,1
"803",1,16,23,7,-6.34361114517932,-12.1826,-8.1206,-2
"804",1,23,18,-5,-18.6449731927431,-0.1826,-3.1206,5
"805",1,25,24,-1,-17.6017096899902,-4.1826,-9.1206,7
"806",1,29,12,-17,-30.0800893818869,11.8174,2.8794,11
"807",1,17,1,-16,-20.9303371898326,10.8174,13.8794,-1
"808",1,17,2,-15,-20.352451715948,9.8174,12.8794,-1
"809",1,18,14,-4,-14.3072037399491,-1.1826,0.8794,0
"810",1,20,0,-20,-25.6090556447487,14.8174,14.8794,2
"811",1,26,26,0,-17.4563708457054,-5.1826,-11.1206,8
"812",1,18,4,-14,-20.5056518361644,8.8174,10.8794,0
"813",1,19,9,-10,-18.9005508002173,4.8174,5.8794,1
"814",1,18,21,3,-10.2156071746328,-8.1826,-6.1206,0
"815",1,18,6,-12,-19.1396831951455,6.8174,8.8794,0
"816",1,23,21,-2,-16.7373071288518,-3.1826,-6.1206,5
"817",1,31,4,-27,-37.1366598030161,21.8174,10.8794,13
"818",1,19,9,-10,-18.8217639103261,4.8174,5.8794,1
"819",1,20,0,-20,-25.6359880134744,14.8174,14.8794,2
"820",1,19,30,11,-6.2120031436751,-16.1826,-15.1206,1
"821",1,33,28,-5,-25.6376942785984,-0.1826,-13.1206,15
"822",1,30,13,-17,-30.5934883065587,11.8174,1.8794,12
"823",1,18,4,-14,-20.5312523932837,8.8174,10.8794,0
"824",1,22,26,4,-12.4832256038162,-9.1826,-11.1206,4
"825",1,21,29,8,-9.59026151239723,-13.1826,-14.1206,3
"826",1,17,13,-4,-14.0839330491628,-1.1826,1.8794,-1
"827",1,16,1,-15,-19.8648488171558,9.8174,13.8794,-2
"828",1,20,25,5,-10.3735754170237,-10.1826,-10.1206,2
"829",1,22,3,-19,-26.2129532325796,13.8174,11.8794,4
"830",1,24,8,-16,-25.73219286253,10.8174,6.8794,6
"831",1,19,29,10,-6.64701329379735,-15.1826,-14.1206,1
"832",1,12,0,-12,-14.9920794850537,6.8174,14.8794,-6
"833",1,12,27,15,0.864413988518315,-20.1826,-12.1206,-6
"834",1,27,5,-22,-31.7105355012484,16.8174,9.8794,9
"835",1,17,20,3,-9.3189880844006,-8.1826,-5.1206,-1
"836",1,22,5,-17,-25.2067290419676,11.8174,9.8794,4
"837",1,25,1,-24,-31.3357245504127,18.8174,13.8794,7
"838",1,14,5,-9,-14.6499940124094,3.8174,9.8794,-4
"839",1,30,3,-27,-36.6357101186143,21.8174,11.8794,12
"840",1,23,14,-9,-20.9717383724346,3.8174,0.8794,5
"841",1,15,6,-9,-15.6430609773174,3.8174,8.8794,-3
"842",1,19,5,-14,-21.3213935984625,8.8174,9.8794,1
"843",1,19,23,4,-10.4240565696542,-9.1826,-8.1206,1
"844",1,19,0,-19,-23.991330218613,13.8174,14.8794,1
"845",1,19,25,6,-9.09536201246042,-11.1826,-10.1206,1
"846",1,24,20,-4,-18.5859048106233,-1.1826,-5.1206,6
"847",1,19,0,-19,-24.5425386433075,13.8174,14.8794,1
"848",1,26,14,-12,-24.7957825377097,6.8174,0.8794,8
"849",1,21,23,2,-12.8050879333149,-7.1826,-8.1206,3
"850",1,19,28,9,-7.28379487043613,-14.1826,-13.1206,1
"851",1,17,13,-4,-13.8860758162229,-1.1826,1.8794,-1
"852",1,23,18,-5,-18.6537795870983,-0.1826,-3.1206,5
"853",1,20,1,-19,-25.1087198895684,13.8174,13.8794,2
"854",1,25,27,2,-15.6619182626214,-7.1826,-12.1206,7
"855",1,18,12,-6,-15.5266209777437,0.8174,2.8794,0
"856",1,14,25,11,-2.73661355272327,-16.1826,-10.1206,-4
"857",1,23,19,-4,-18.1867931672725,-1.1826,-4.1206,5
"858",1,24,2,-22,-29.7010206028313,16.8174,12.8794,6
"859",1,25,5,-20,-28.9161086242189,14.8174,9.8794,7
"860",1,16,25,9,-5.54184711072878,-14.1826,-10.1206,-2
"861",1,16,27,11,-4.09997074087188,-16.1826,-12.1206,-2
"862",1,14,9,-5,-12.1914956281337,-0.1826,5.8794,-4
"863",1,22,23,1,-14.3912059003266,-6.1826,-8.1206,4
"864",1,18,3,-15,-21.1651117618258,9.8174,11.8794,0
"865",1,27,18,-9,-24.1235023472386,3.8174,-3.1206,9
"866",1,13,3,-10,-14.5605974433064,4.8174,11.8794,-5
"867",1,22,7,-15,-23.9641168803766,9.8174,7.8794,4
"868",1,15,19,4,-7.5666307084933,-9.1826,-4.1206,-3
"869",1,27,19,-8,-23.2027396771312,2.8174,-4.1206,9
"870",1,18,20,2,-10.8074546375563,-7.1826,-5.1206,0
"871",1,14,22,8,-4.64907090897839,-13.1826,-7.1206,-4
"872",1,27,5,-22,-31.6876765756556,16.8174,9.8794,9
"873",1,23,24,1,-14.9060531857623,-6.1826,-9.1206,5
"874",1,19,14,-5,-15.9525168222192,-0.1826,0.8794,1
"875",1,28,28,0,-19.1932598502877,-5.1826,-13.1206,10
"876",1,26,4,-22,-31.2188384292709,16.8174,10.8794,8
"877",1,22,16,-6,-18.501974054256,0.8174,-1.1206,4
"878",1,14,3,-11,-15.8813963390416,5.8174,11.8794,-4
"879",1,30,7,-23,-34.1575048825155,17.8174,7.8794,12
"880",1,24,28,4,-13.9334531311379,-9.1826,-13.1206,6
"881",1,23,12,-11,-22.1822467129676,5.8174,2.8794,5
"882",1,21,17,-4,-16.6995058366222,-1.1826,-2.1206,3
"883",1,21,7,-14,-22.8100395433806,8.8174,7.8794,3
"884",1,25,14,-11,-23.5972402941336,5.8174,0.8794,7
"885",1,21,2,-19,-25.4841450868568,13.8174,12.8794,3
"886",1,29,8,-21,-32.4727668598449,15.8174,6.8794,11
"887",1,27,4,-23,-32.1202342213514,17.8174,10.8794,9
"888",1,25,30,5,-14.0594493728555,-10.1826,-15.1206,7
"889",1,27,9,-18,-29.3383635530566,12.8174,5.8794,9
"890",1,14,8,-6,-12.9191096984781,0.8174,6.8794,-4
"891",1,20,0,-20,-25.5126438697431,14.8174,14.8794,2
"892",1,16,16,0,-10.7125359894285,-5.1826,-1.1206,-2
"893",1,24,26,2,-15.1995545664259,-7.1826,-11.1206,6
"894",1,21,23,2,-12.9983994900576,-7.1826,-8.1206,3
"895",1,27,14,-13,-26.1148838749052,7.8174,0.8794,9
"896",1,21,4,-17,-24.3098735428497,11.8174,10.8794,3
"897",1,21,8,-13,-22.323660270106,7.8174,6.8794,3
"898",1,17,3,-14,-19.7901178940451,8.8174,11.8794,-1
"899",1,17,9,-8,-16.2773248207076,2.8174,5.8794,-1
"900",1,26,5,-21,-30.3487878473696,15.8174,9.8794,8
"901",1,15,11,-4,-12.4476240114855,-1.1826,3.8794,-3
"902",1,24,15,-9,-21.6117582630503,3.8174,-0.1206,6
"903",1,23,28,5,-12.6040773961109,-10.1826,-13.1206,5
"904",1,19,18,-1,-13.2096978267905,-4.1826,-3.1206,1
"905",1,16,19,3,-9.01629159008817,-8.1826,-4.1206,-2
"906",1,20,11,-9,-18.9519436436523,3.8174,3.8794,2
"907",1,20,19,-1,-13.9544696134536,-4.1826,-4.1206,2
"908",1,21,29,8,-9.28631988037062,-13.1826,-14.1206,3
"909",1,28,23,-5,-21.756200673436,-0.1826,-8.1206,10
"910",1,19,30,11,-6.20491624069068,-16.1826,-15.1206,1
"911",1,14,2,-12,-16.3509985028017,6.8174,12.8794,-4
"912",1,20,28,8,-8.81125952422772,-13.1826,-13.1206,2
"913",1,14,14,0,-9.11467768651161,-5.1826,0.8794,-4
"914",1,23,24,1,-15.019690385308,-6.1826,-9.1206,5
"915",1,21,8,-13,-22.0025364296722,7.8174,6.8794,3
"916",1,25,1,-24,-31.4926057052808,18.8174,13.8794,7
"917",1,14,24,10,-3.33475247744852,-15.1826,-9.1206,-4
"918",1,21,1,-20,-26.1729491284425,14.8174,13.8794,3
"919",1,25,18,-7,-20.9498019801284,1.8174,-3.1206,7
"920",1,19,19,0,-12.6715399823612,-5.1826,-4.1206,1
"921",1,19,21,2,-11.5644112471061,-7.1826,-6.1206,1
"922",1,20,4,-16,-23.0241598781297,10.8174,10.8794,2
"923",1,20,22,2,-12.3400857503357,-7.1826,-7.1206,2
"924",1,15,15,0,-9.96721964314582,-5.1826,-0.1206,-3
"925",1,17,20,3,-9.60380445114376,-8.1826,-5.1206,-1
"926",1,19,20,1,-12.2600826583677,-6.1826,-5.1206,1
"927",1,17,6,-11,-18.0716783599607,5.8174,8.8794,-1
"928",1,32,10,-22,-34.7134330805208,16.8174,4.8794,14
"929",1,18,16,-2,-13.0410747214929,-3.1826,-1.1206,0
"930",1,24,23,-1,-16.7195510870012,-4.1826,-8.1206,6
"931",1,18,21,3,-10.0726402580607,-8.1826,-6.1206,0
"932",1,22,28,6,-11.2106547143676,-11.1826,-13.1206,4
"933",1,14,30,16,0.379833074181173,-21.1826,-15.1206,-4
"934",1,23,2,-21,-28.0481204978182,15.8174,12.8794,5
"935",1,21,3,-18,-24.7399495673579,12.8174,11.8794,3
"936",1,22,23,1,-14.345911989059,-6.1826,-8.1206,4
"937",1,20,0,-20,-25.7293977220302,14.8174,14.8794,2
"938",1,16,13,-3,-12.4450970440153,-2.1826,1.8794,-2
"939",1,17,7,-10,-17.7083798488839,4.8174,7.8794,-1
"940",1,26,9,-17,-27.9134989355466,11.8174,5.8794,8
"941",1,19,0,-19,-24.2499066931397,13.8174,14.8794,1
"942",1,24,12,-12,-23.3752043028057,6.8174,2.8794,6
"943",1,24,19,-5,-19.2709435730282,-0.1826,-4.1206,6
"944",1,16,12,-4,-12.932188359534,-1.1826,2.8794,-2
"945",1,17,9,-8,-16.301144579603,2.8174,5.8794,-1
"946",1,24,4,-20,-28.297480746597,14.8174,10.8794,6
"947",1,20,30,10,-7.53626446808194,-15.1826,-15.1206,2
"948",1,19,16,-3,-14.7403145526085,-2.1826,-1.1206,1
"949",1,20,10,-10,-19.5626436720428,4.8174,4.8794,2
"950",1,18,8,-10,-18.2540990891449,4.8174,6.8794,0
"951",1,16,20,4,-8.20272304296793,-9.1826,-5.1206,-2
"952",1,20,27,7,-9.17558744356272,-12.1826,-12.1206,2
"953",1,24,17,-7,-20.6488346905845,1.8174,-2.1206,6
"954",1,19,18,-1,-13.2921938882259,-4.1826,-3.1206,1
"955",1,23,4,-19,-27.0392468155021,13.8174,10.8794,5
"956",1,21,1,-20,-26.1638436597141,14.8174,13.8794,3
"957",1,18,19,1,-11.5387460792291,-6.1826,-4.1206,0
"958",1,20,9,-11,-19.8785804418174,5.8174,5.8794,2
"959",1,17,4,-13,-19.2045421040775,7.8174,10.8794,-1
"960",1,24,5,-19,-27.7354136256126,13.8174,9.8794,6
"961",1,19,6,-13,-20.540187163907,7.8174,8.8794,1
"962",1,24,10,-14,-24.5610605735582,8.8174,4.8794,6
"963",1,21,10,-11,-20.6289902815046,5.8174,4.8794,3
"964",1,17,4,-13,-19.0087569589414,7.8174,10.8794,-1
"965",1,27,24,-3,-20.0214360632682,-2.1826,-9.1206,9
"966",1,21,12,-9,-19.454477641723,3.8174,2.8794,3
"967",1,21,6,-15,-23.2709967561859,9.8174,8.8794,3
"968",1,23,20,-3,-17.4808655787694,-2.1826,-5.1206,5
"969",1,18,13,-5,-15.1429925388861,-0.1826,1.8794,0
"970",1,20,14,-6,-17.0944353944468,0.8174,0.8794,2
"971",1,23,15,-8,-20.2836416145325,2.8174,-0.1206,5
"972",1,15,21,6,-6.36464413149368,-11.1826,-6.1206,-3
"973",1,24,2,-22,-29.562168898714,16.8174,12.8794,6
"974",1,17,15,-2,-12.5517407853402,-3.1826,-0.1206,-1
"975",1,25,2,-23,-31.209165824188,17.8174,12.8794,7
"976",1,14,7,-7,-13.3209724020081,1.8174,7.8794,-4
"977",1,19,12,-7,-16.8875643286912,1.8174,2.8794,1
"978",1,20,2,-18,-24.4896249158305,12.8174,12.8794,2
"979",1,18,14,-4,-14.5290169317492,-1.1826,0.8794,0
"980",1,19,4,-15,-21.657433074533,9.8174,10.8794,1
"981",1,21,5,-16,-23.5942410897668,10.8174,9.8794,3
"982",1,25,19,-6,-20.6522819942518,0.8174,-4.1206,7
"983",1,24,29,5,-13.1820896039292,-10.1826,-14.1206,6
"984",1,17,9,-8,-16.2184780341385,2.8174,5.8794,-1
"985",1,19,0,-19,-24.2730921540185,13.8174,14.8794,1
"986",1,17,21,4,-9.02820445409705,-9.1826,-6.1206,-1
"987",1,18,7,-11,-18.6385540026724,5.8174,7.8794,0
"988",1,20,13,-7,-17.9546410652472,1.8174,1.8794,2
"989",1,19,27,8,-7.52604482563066,-13.1826,-12.1206,1
"990",1,25,20,-5,-20.0806394476733,-0.1826,-5.1206,7
"991",1,31,11,-20,-33.1511026367514,14.8174,3.8794,13
"992",1,22,8,-14,-23.2467482709304,8.8174,6.8794,4
"993",1,21,1,-20,-26.1035780006183,14.8174,13.8794,3
"994",1,19,20,1,-12.2460227282927,-6.1826,-5.1206,1
"995",1,18,0,-18,-22.7272401533716,12.8174,14.8794,0
"996",1,24,28,4,-13.9648304782639,-9.1826,-13.1206,6
"997",1,15,8,-7,-14.1990214137833,1.8174,6.8794,-3
"998",1,12,5,-7,-12.0736405409756,1.8174,9.8794,-6
"999",1,22,14,-8,-19.5560352840022,2.8174,0.8794,4
"1000",1,24,30,6,-12.7927975598261,-11.1826,-15.1206,6
"1001",1,25,20,-5,-19.6616159161483,-0.1826,-5.1206,7
"1002",1,22,2,-20,-26.9101625897605,14.8174,12.8794,4
"1003",1,20,8,-12,-20.8045051063894,6.8174,6.8794,2
"1004",1,29,12,-17,-29.8111996448535,11.8174,2.8794,11
"1005",1,25,7,-18,-27.7741705643274,12.8174,7.8794,7
"1006",1,16,21,5,-7.77615344385384,-10.1826,-6.1206,-2
"1007",1,25,29,4,-14.81314829994,-9.1826,-14.1206,7
"1008",1,19,1,-18,-23.7145601334234,12.8174,13.8794,1
"1009",1,23,7,-16,-24.8725149615576,10.8174,7.8794,5
"1010",1,16,21,5,-7.90475375556355,-10.1826,-6.1206,-2
"1011",1,23,27,4,-13.168251963756,-9.1826,-12.1206,5
"1012",1,20,30,10,-7.44101953749538,-15.1826,-15.1206,2
"1013",1,22,15,-7,-19.1335105960358,1.8174,-0.1206,4
"1014",1,24,24,0,-16.2602927566002,-5.1826,-9.1206,6
"1015",1,18,27,9,-6.85787082753123,-14.1826,-12.1206,0
"1016",1,20,16,-4,-16.0171862572101,-1.1826,-1.1206,2
"1017",1,16,22,6,-7.06517400288056,-11.1826,-7.1206,-2
"1018",1,25,14,-11,-23.6792839047702,5.8174,0.8794,7
"1019",1,15,25,10,-4.05330672175587,-15.1826,-10.1206,-3
"1020",1,20,7,-13,-21.2680894651597,7.8174,7.8794,2
"1021",1,17,0,-17,-21.5247870473409,11.8174,14.8794,-1
"1022",1,19,0,-19,-24.2133325596986,13.8174,14.8794,1
"1023",1,19,0,-19,-24.1188353361602,13.8174,14.8794,1
"1024",1,27,24,-3,-20.1212111058361,-2.1826,-9.1206,9
"1025",1,16,16,0,-10.5297214696052,-5.1826,-1.1206,-2
"1026",1,17,23,6,-7.59390705871508,-11.1826,-8.1206,-1
"1027",1,13,4,-9,-14.1574717624904,3.8174,10.8794,-5
"1028",1,12,22,10,-2.09682186552916,-15.1826,-7.1206,-6
"1029",1,16,22,6,-7.30370934361825,-11.1826,-7.1206,-2
"1030",1,16,23,7,-6.51579884397666,-12.1826,-8.1206,-2
"1031",1,18,13,-5,-15.0158978282348,-0.1826,1.8794,0
"1032",1,24,28,4,-14.1170351320932,-9.1826,-13.1206,6
"1033",1,26,12,-14,-26.3004472569317,8.8174,2.8794,8
"1034",1,20,22,2,-12.4569377595524,-7.1826,-7.1206,2
"1035",1,18,12,-6,-15.9016402607537,0.8174,2.8794,0
"1036",1,17,7,-10,-17.142100619736,4.8174,7.8794,-1
"1037",1,19,3,-16,-22.4175159979295,10.8174,11.8794,1
"1038",1,21,5,-16,-23.7978110875079,10.8174,9.8794,3
"1039",1,17,3,-14,-19.8854749753203,8.8174,11.8794,-1
"1040",1,16,11,-5,-13.6564837098122,-0.1826,3.8794,-2
"1041",1,18,2,-16,-21.6004613539649,10.8174,12.8794,0
"1042",1,18,10,-8,-17.0885320355925,2.8174,4.8794,0
"1043",1,17,20,3,-9.60554077292799,-8.1826,-5.1206,-1
"1044",1,25,3,-22,-30.0460596619758,16.8174,11.8794,7
"1045",1,25,25,0,-17.1676684582011,-5.1826,-10.1206,7
"1046",1,25,16,-9,-22.1430130114829,3.8174,-1.1206,7
"1047",1,17,23,6,-8.08147592896712,-11.1826,-8.1206,-1
"1048",1,16,10,-6,-14.5968624003062,0.8174,4.8794,-2
"1049",1,16,1,-15,-19.6257522192622,9.8174,13.8794,-2
"1050",1,19,9,-10,-18.6244537357594,4.8174,5.8794,1
"1051",1,25,17,-8,-21.6147432677407,2.8174,-2.1206,7
"1052",1,20,20,0,-13.3629670372368,-5.1826,-5.1206,2
"1053",1,30,0,-30,-38.4463813444164,24.8174,14.8794,12
"1054",1,20,28,8,-8.58525556454429,-13.1826,-13.1206,2
"1055",1,15,15,0,-9.80928244228599,-5.1826,-0.1206,-3
"1056",1,28,9,-19,-30.6720305549573,13.8174,5.8794,10
"1057",1,18,15,-3,-13.8171707364015,-2.1826,-0.1206,0
"1058",1,23,9,-14,-23.9958617326684,8.8174,5.8794,5
"1059",1,30,24,-6,-24.220887841459,0.8174,-9.1206,12
"1060",1,18,19,1,-11.1887170625633,-6.1826,-4.1206,0
"1061",1,13,15,2,-7.51000163345933,-7.1826,-0.1206,-5
"1062",1,24,28,4,-13.8251843331124,-9.1826,-13.1206,6
"1063",1,18,20,2,-10.9940531046757,-7.1826,-5.1206,0
"1064",1,28,17,-11,-25.7483554709436,5.8174,-2.1206,10
"1065",1,27,8,-19,-29.7518259964182,13.8174,6.8794,9
"1066",1,17,8,-9,-16.6977154394696,3.8174,6.8794,-1
"1067",1,15,14,-1,-10.6239910964026,-4.1826,0.8794,-3
"1068",1,14,23,9,-3.9526352006101,-14.1826,-8.1206,-4
"1069",1,22,11,-11,-21.547800189901,5.8174,3.8794,4
"1070",1,15,11,-4,-12.3214389942854,-1.1826,3.8794,-3
"1071",1,24,17,-7,-20.3420532388896,1.8174,-2.1206,6
"1072",1,11,25,14,1.20685905246977,-19.1826,-10.1206,-7
"1073",1,17,18,1,-10.6122137053802,-6.1826,-3.1206,-1
"1074",1,14,1,-13,-16.9489837418714,7.8174,13.8794,-4
"1075",1,23,5,-18,-26.2485272420557,12.8174,9.8794,5
"1076",1,32,10,-22,-35.2423051893286,16.8174,4.8794,14
"1077",1,21,8,-13,-22.0277553972677,7.8174,6.8794,3
"1078",1,23,10,-13,-23.5302140291464,7.8174,4.8794,5
"1079",1,22,20,-2,-16.0911838074081,-3.1826,-5.1206,4
"1080",1,21,8,-13,-22.2483606152907,7.8174,6.8794,3
"1081",1,24,23,-1,-17.0599880326524,-4.1826,-8.1206,6
"1082",1,21,10,-11,-20.7091363970579,5.8174,4.8794,3
"1083",1,20,1,-19,-24.9130863765231,13.8174,13.8794,2
"1084",1,29,19,-10,-25.9421599297354,4.8174,-4.1206,11
"1085",1,20,17,-3,-15.4586384856333,-2.1826,-2.1206,2
"1086",1,19,17,-2,-14.1073670316618,-3.1826,-2.1206,1
"1087",1,25,2,-23,-30.6910770131074,17.8174,12.8794,7
"1088",1,20,23,3,-11.63666938883,-8.1826,-8.1206,2
"1089",1,13,27,14,-0.0347990808066355,-19.1826,-12.1206,-5
"1090",1,22,1,-21,-27.4315767222991,15.8174,13.8794,4
"1091",1,22,27,5,-11.9321876116655,-10.1826,-12.1206,4
"1092",1,17,1,-16,-20.9945980801086,10.8174,13.8794,-1
"1093",1,18,11,-7,-16.1808189696665,1.8174,3.8794,0
"1094",1,16,9,-7,-15.0515324751397,1.8174,5.8794,-2
"1095",1,19,7,-12,-19.9831797796957,6.8174,7.8794,1
"1096",1,19,19,0,-13.0543473362848,-5.1826,-4.1206,1
"1097",1,18,21,3,-10.4323859187858,-8.1826,-6.1206,0
"1098",1,18,14,-4,-14.6090231285028,-1.1826,0.8794,0
"1099",1,18,11,-7,-16.3157809130862,1.8174,3.8794,0
"1100",1,25,26,1,-16.2562236513188,-6.1826,-11.1206,7
"1101",1,18,16,-2,-13.2292435042873,-3.1826,-1.1206,0
"1102",1,20,0,-20,-25.4533799034468,14.8174,14.8794,2
"1103",1,16,11,-5,-13.72611429303,-0.1826,3.8794,-2
"1104",1,24,3,-21,-28.7599371232065,15.8174,11.8794,6
"1105",1,30,20,-10,-26.2275384203004,4.8174,-5.1206,12
"1106",1,23,17,-6,-19.2038488810344,0.8174,-2.1206,5
"1107",1,16,18,2,-9.47001356477849,-7.1826,-3.1206,-2
"1108",1,24,12,-12,-23.5409091295736,6.8174,2.8794,6
"1109",1,15,10,-5,-12.8457969703461,-0.1826,4.8794,-3
"1110",1,20,5,-15,-22.4323362705741,9.8174,9.8794,2
"1111",1,24,30,6,-12.8875001996895,-11.1826,-15.1206,6
"1112",1,21,13,-8,-18.9973703127384,2.8174,1.8794,3
"1113",1,28,30,2,-17.7377844001459,-7.1826,-15.1206,10
"1114",1,32,12,-20,-33.8371951770309,14.8174,2.8794,14
"1115",1,16,1,-15,-19.7220920793611,9.8174,13.8794,-2
"1116",1,23,19,-4,-18.0774511852714,-1.1826,-4.1206,5
"1117",1,16,6,-10,-16.7380504134697,4.8174,8.8794,-2
"1118",1,25,4,-21,-29.7347456038239,15.8174,10.8794,7
"1119",1,16,5,-11,-17.1253136337751,5.8174,9.8794,-2
"1120",1,22,13,-9,-20.3760319643215,3.8174,1.8794,4
"1121",1,21,16,-5,-17.2708928246993,-0.1826,-1.1206,3
"1122",1,21,2,-19,-25.5276501943931,13.8174,12.8794,3
"1123",1,23,16,-7,-19.8392478550637,1.8174,-1.1206,5
"1124",1,12,25,13,-0.0313094895922809,-18.1826,-10.1206,-6
"1125",1,15,19,4,-7.70327111814425,-9.1826,-4.1206,-3
"1126",1,11,27,16,2.39672164291819,-21.1826,-12.1206,-7
"1127",1,20,15,-5,-16.5298868681201,-0.1826,-0.1206,2
"1128",1,20,22,2,-12.3026185085357,-7.1826,-7.1206,2
"1129",1,14,30,16,0.522600155634933,-21.1826,-15.1206,-4
"1130",1,26,7,-19,-29.0443450676434,13.8174,7.8794,8
"1131",1,27,16,-11,-24.7752265451808,5.8174,-1.1206,9
"1132",1,27,15,-12,-25.4375915434935,6.8174,-0.1206,9
"1133",1,17,29,12,-4.23794618009857,-17.1826,-14.1206,-1
"1134",1,11,0,-11,-13.8387620780245,5.8174,14.8794,-7
"1135",1,15,17,2,-8.67081337614573,-7.1826,-2.1206,-3
"1136",1,26,11,-15,-26.6479422009564,9.8174,3.8794,8
"1137",1,20,8,-12,-20.6244984659335,6.8174,6.8794,2
"1138",1,26,27,1,-17.0127529618395,-6.1826,-12.1206,8
"1139",1,26,9,-17,-28.0737006420697,11.8174,5.8794,8
"1140",1,14,27,13,-1.42641720436557,-18.1826,-12.1206,-4
"1141",1,24,9,-15,-25.2490684561864,9.8174,5.8794,6
"1142",1,17,5,-12,-18.7742581543076,6.8174,9.8794,-1
"1143",1,21,21,0,-14.1581559575926,-5.1826,-6.1206,3
"1144",1,24,2,-22,-29.4869762829339,16.8174,12.8794,6
"1145",1,25,9,-16,-26.7642137746014,10.8174,5.8794,7
"1146",1,18,30,12,-4.8338914126858,-17.1826,-15.1206,0
"1147",1,30,6,-24,-35.0485299646255,18.8174,8.8794,12
"1148",1,21,17,-4,-16.7087561935059,-1.1826,-2.1206,3
"1149",1,22,19,-3,-16.6312222281033,-2.1826,-4.1206,4
"1150",1,19,13,-6,-16.413538757587,0.8174,1.8794,1
"1151",1,21,16,-5,-17.3548339024918,-0.1826,-1.1206,3
"1152",1,11,11,0,-7.02968382329362,-5.1826,3.8794,-7
"1153",1,17,19,2,-10.3222269446731,-7.1826,-4.1206,-1
"1154",1,27,11,-16,-28.1199236813299,10.8174,3.8794,9
"1155",1,20,23,3,-11.6751078032003,-8.1826,-8.1206,2
"1156",1,24,6,-18,-27.0430497063994,12.8174,8.8794,6
"1157",1,25,13,-12,-24.175000802851,6.8174,1.8794,7
"1158",1,25,7,-18,-27.645963949914,12.8174,7.8794,7
"1159",1,19,17,-2,-14.3928427357235,-3.1826,-2.1206,1
"1160",1,14,5,-9,-14.7535739591194,3.8174,9.8794,-4
"1161",1,11,27,16,2.35655285339089,-21.1826,-12.1206,-7
"1162",1,15,15,0,-10.0762329570003,-5.1826,-0.1206,-3
"1163",1,19,30,11,-6.01707498566582,-16.1826,-15.1206,1
"1164",1,22,26,4,-12.3549126436821,-9.1826,-11.1206,4
"1165",1,30,0,-30,-38.5481574143166,24.8174,14.8794,12
"1166",1,31,23,-8,-25.9962357888506,2.8174,-8.1206,13
"1167",1,22,6,-16,-24.5744813669297,10.8174,8.8794,4
"1168",1,28,11,-17,-29.4046190678563,11.8174,3.8794,10
"1169",1,16,5,-11,-17.1199514877957,5.8174,9.8794,-2
"1170",1,29,11,-18,-30.5034895287984,12.8174,3.8794,11
"1171",1,24,8,-16,-26.0153857065383,10.8174,6.8794,6
"1172",1,16,7,-9,-16.3267480169829,3.8174,7.8794,-2
"1173",1,24,12,-12,-23.2330883290144,6.8174,2.8794,6
"1174",1,16,22,6,-7.18731229909387,-11.1826,-7.1206,-2
"1175",1,21,13,-8,-19.0472427616959,2.8174,1.8794,3
"1176",1,20,27,7,-9.35931009957985,-12.1826,-12.1206,2
"1177",1,16,11,-5,-13.7107594381755,-0.1826,3.8794,-2
"1178",1,23,1,-22,-28.8572922063776,16.8174,13.8794,5
"1179",1,20,22,2,-12.1216876383929,-7.1826,-7.1206,2
"1180",1,20,24,4,-11.0285563510392,-9.1826,-9.1206,2
"1181",1,21,18,-3,-16.0531192002036,-2.1826,-3.1206,3
"1182",1,19,22,3,-11.1363180520196,-8.1826,-7.1206,1
"1183",1,14,2,-12,-16.4472917994927,6.8174,12.8794,-4
"1184",1,22,4,-18,-25.4707098878848,12.8174,10.8794,4
"1185",1,16,18,2,-9.67611873619575,-7.1826,-3.1206,-2
"1186",1,28,26,-2,-20.2267840335942,-3.1826,-11.1206,10
"1187",1,11,14,3,-5.30806199415442,-8.1826,0.8794,-7
"1188",1,16,4,-12,-17.8071878973562,6.8174,10.8794,-2
"1189",1,19,15,-4,-15.2403210254575,-1.1826,-0.1206,1
"1190",1,20,7,-13,-21.3713050136402,7.8174,7.8794,2
"1191",1,18,15,-3,-13.8292634378325,-2.1826,-0.1206,0
"1192",1,27,9,-18,-28.8936242542542,12.8174,5.8794,9
"1193",1,13,18,5,-5.49913345643974,-10.1826,-3.1206,-5
"1194",1,20,18,-2,-14.7424276490957,-3.1826,-3.1206,2
"1195",1,23,22,-1,-16.0958535600219,-4.1826,-7.1206,5
"1196",1,16,18,2,-9.62179803980904,-7.1826,-3.1206,-2
"1197",1,13,29,16,1.06007387288458,-21.1826,-14.1206,-5
"1198",1,21,11,-10,-20.0286376024852,4.8174,3.8794,3
"1199",1,20,24,4,-11.1996089591514,-9.1826,-9.1206,2
"1200",1,27,5,-22,-31.6323290173243,16.8174,9.8794,9
"1201",1,20,7,-13,-21.0427428763326,7.8174,7.8794,2
"1202",1,16,23,7,-6.58219711809856,-12.1826,-8.1206,-2
"1203",1,25,10,-15,-25.9738464082895,9.8174,4.8794,7
"1204",1,17,2,-15,-20.4340239571292,9.8174,12.8794,-1
"1205",1,19,21,2,-11.7586973844964,-7.1826,-6.1206,1
"1206",1,27,25,-2,-19.7697124316485,-3.1826,-10.1206,9
"1207",1,16,6,-10,-16.68974326101,4.8174,8.8794,-2
"1208",1,11,28,17,2.88718373567098,-22.1826,-13.1206,-7
"1209",1,25,27,2,-15.8063125343912,-7.1826,-12.1206,7
"1210",1,21,15,-6,-17.6791586266957,0.8174,-0.1206,3
"1211",1,20,19,-1,-14.1131760822242,-4.1826,-4.1206,2
"1212",1,22,24,2,-13.3976052627813,-7.1826,-9.1206,4
"1213",1,19,1,-18,-23.8466313527161,12.8174,13.8794,1
"1214",1,21,28,7,-9.91259702664023,-12.1826,-13.1206,3
"1215",1,20,14,-6,-17.1056656752272,0.8174,0.8794,2
"1216",1,28,3,-25,-33.7350140942148,19.8174,11.8794,10
"1217",1,19,23,4,-10.1774457243985,-9.1826,-8.1206,1
"1218",1,33,7,-26,-37.9557161539656,20.8174,7.8794,15
"1219",1,27,26,-1,-19.0439503491487,-4.1826,-11.1206,9
"1220",1,28,5,-23,-32.7452211013116,17.8174,9.8794,10
"1221",1,24,27,3,-14.7266723214379,-8.1826,-12.1206,6
"1222",1,15,14,-1,-10.5789989284357,-4.1826,0.8794,-3
"1223",1,18,24,6,-8.36537023102323,-11.1826,-9.1206,0
"1224",1,19,6,-13,-20.4613550105429,7.8174,8.8794,1
"1225",1,27,26,-1,-19.164768285322,-4.1826,-11.1206,9
"1226",1,24,9,-15,-25.4012927448343,9.8174,5.8794,6
"1227",1,20,30,10,-7.72144041949058,-15.1826,-15.1206,2
"1228",1,16,22,6,-7.07142343189433,-11.1826,-7.1206,-2
"1229",1,34,0,-34,-43.5484855901361,28.8174,14.8794,16
"1230",1,25,6,-19,-28.3982205488898,13.8174,8.8794,7
"1231",1,15,27,12,-2.57188796993664,-17.1826,-12.1206,-3
"1232",1,17,27,10,-5.23264709309554,-15.1826,-12.1206,-1
"1233",1,25,5,-20,-28.9553960047329,14.8174,9.8794,7
"1234",1,16,30,14,-2.05700590578847,-19.1826,-15.1206,-2
"1235",1,21,25,4,-11.6937564880936,-9.1826,-10.1206,3
"1236",1,14,1,-13,-17.1568206486199,7.8174,13.8794,-4
"1237",1,15,26,11,-3.38556338763761,-16.1826,-11.1206,-3
"1238",1,13,25,12,-1.56708426025342,-17.1826,-10.1206,-5
"1239",1,30,29,-1,-21.0183022654886,-4.1826,-14.1206,12
"1240",1,21,17,-4,-16.4288034862579,-1.1826,-2.1206,3
"1241",1,20,30,10,-7.59763834828142,-15.1826,-15.1206,2
"1242",1,19,20,1,-12.1713748098426,-6.1826,-5.1206,1
"1243",1,13,28,15,0.403676758721653,-20.1826,-13.1206,-5
"1244",1,28,23,-5,-22.1052682842996,-0.1826,-8.1206,10
"1245",1,16,18,2,-9.6085905082181,-7.1826,-3.1206,-2
"1246",1,18,1,-17,-22.6434328879947,11.8174,13.8794,0
"1247",1,16,4,-12,-17.8389460913701,6.8174,10.8794,-2
"1248",1,15,21,6,-6.26012482796456,-11.1826,-6.1206,-3
"1249",1,15,23,8,-5.22066454910415,-13.1826,-8.1206,-3
"1250",1,19,2,-17,-22.9368051855608,11.8174,12.8794,1
"1251",1,24,9,-15,-25.2248673737571,9.8174,5.8794,6
"1252",1,12,27,15,1.15154346190212,-20.1826,-12.1206,-6
"1253",1,24,27,3,-14.5525114100125,-8.1826,-12.1206,6
"1254",1,20,15,-5,-16.527779843007,-0.1826,-0.1206,2
"1255",1,17,26,9,-6.02758133787448,-14.1826,-11.1206,-1
"1256",1,18,0,-18,-23.1078866801993,12.8174,14.8794,0
"1257",1,20,22,2,-12.2639143657389,-7.1826,-7.1206,2
"1258",1,16,15,-1,-10.8961810550013,-4.1826,-0.1206,-2
"1259",1,13,15,2,-7.38032467033466,-7.1826,-0.1206,-5
"1260",1,22,4,-18,-25.6309411158163,12.8174,10.8794,4
"1261",1,24,11,-13,-24.054630326723,7.8174,3.8794,6
"1262",1,18,3,-15,-20.8036973262155,9.8174,11.8794,0
"1263",1,20,2,-18,-24.0706735680137,12.8174,12.8794,2
"1264",1,16,4,-12,-17.7880890861885,6.8174,10.8794,-2
"1265",1,29,23,-6,-23.3185466096922,0.8174,-8.1206,11
"1266",1,22,29,7,-10.5699996587758,-12.1826,-14.1206,4
"1267",1,19,0,-19,-23.9334061645211,13.8174,14.8794,1
"1268",1,20,9,-11,-20.1474256696643,5.8174,5.8794,2
"1269",1,17,17,0,-11.1356263664449,-5.1826,-2.1206,-1
"1270",1,17,21,4,-9.25348895537431,-9.1826,-6.1206,-1
"1271",1,17,3,-14,-19.8004535709318,8.8174,11.8794,-1
"1272",1,31,18,-13,-29.2504813830875,7.8174,-3.1206,13
"1273",1,15,14,-1,-10.4423097520275,-4.1826,0.8794,-3
"1274",1,17,27,10,-5.29021759897463,-15.1826,-12.1206,-1
"1275",1,27,23,-4,-20.9433868082731,-1.1826,-8.1206,9
"1276",1,26,25,-1,-18.0993787832953,-4.1826,-10.1206,8
"1277",1,23,3,-20,-27.6871244246783,14.8174,11.8794,5
"1278",1,21,8,-13,-21.9469192180164,7.8174,6.8794,3
"1279",1,12,26,14,0.32487516456459,-19.1826,-11.1206,-6
"1280",1,17,2,-15,-20.3352002253352,9.8174,12.8794,-1
"1281",1,20,2,-18,-24.346089879228,12.8174,12.8794,2
"1282",1,20,4,-16,-22.8675303785435,10.8174,10.8794,2
"1283",1,17,2,-15,-20.410736790724,9.8174,12.8794,-1
"1284",1,21,28,7,-9.85972254057552,-12.1826,-13.1206,3
"1285",1,15,7,-8,-14.6555918606902,2.8174,7.8794,-3
"1286",1,23,1,-22,-28.6480094608834,16.8174,13.8794,5
"1287",1,22,8,-14,-23.2362231118818,8.8174,6.8794,4
"1288",1,12,27,15,1.12100304088653,-20.1826,-12.1206,-6
"1289",1,18,5,-13,-20.1194562610362,7.8174,9.8794,0
"1290",1,14,4,-10,-15.348818682101,4.8174,10.8794,-4
"1291",1,22,30,8,-10.0884827946413,-13.1826,-15.1206,4
"1292",1,22,18,-4,-17.2120652225115,-1.1826,-3.1206,4
"1293",1,19,14,-5,-15.9582349816937,-0.1826,0.8794,1
"1294",1,17,16,-1,-12.0618410188396,-4.1826,-1.1206,-1
"1295",1,29,6,-23,-33.3429170195431,17.8174,8.8794,11
"1296",1,19,12,-7,-16.9249991736177,1.8174,2.8794,1
"1297",1,29,4,-25,-34.7761092576356,19.8174,10.8794,11
"1298",1,18,6,-12,-19.264690358408,6.8174,8.8794,0
"1299",1,26,30,4,-15.2139197029482,-9.1826,-15.1206,8
"1300",1,32,28,-4,-24.4146785912213,-1.1826,-13.1206,14
"1301",1,14,13,-1,-9.974929663526,-4.1826,1.8794,-4
"1302",1,18,15,-3,-13.7291679689427,-2.1826,-0.1206,0
"1303",1,15,1,-14,-18.5289163428169,8.8174,13.8794,-3
"1304",1,17,23,6,-7.8013670125571,-11.1826,-8.1206,-1
"1305",1,16,22,6,-7.0769769438609,-11.1826,-7.1206,-2
"1306",1,15,4,-11,-16.5166561522044,5.8174,10.8794,-3
"1307",1,20,30,10,-7.31176802185465,-15.1826,-15.1206,2
"1308",1,21,15,-6,-17.6216328119336,0.8174,-0.1206,3
"1309",1,26,25,-1,-18.1618634965298,-4.1826,-10.1206,8
"1310",1,18,9,-9,-17.7040962860112,3.8174,5.8794,0
"1311",1,24,5,-19,-27.5166135639363,13.8174,9.8794,6
"1312",1,18,4,-14,-20.8275361431139,8.8174,10.8794,0
"1313",1,14,6,-8,-14.0433976225237,2.8174,8.8794,-4
"1314",1,28,9,-19,-30.7596760511562,13.8174,5.8794,10
"1315",1,16,14,-2,-11.6994355462432,-3.1826,0.8794,-2
"1316",1,24,7,-17,-26.4613668102355,11.8174,7.8794,6
"1317",1,22,22,0,-14.7510177602464,-5.1826,-7.1206,4
"1318",1,18,27,9,-6.76501641756886,-14.1826,-12.1206,0
"1319",1,19,16,-3,-14.5578071722205,-2.1826,-1.1206,1
"1320",1,16,19,3,-8.77490277929715,-8.1826,-4.1206,-2
"1321",1,19,27,8,-7.74254135341431,-13.1826,-12.1206,1
"1322",1,19,0,-19,-23.8322033837338,13.8174,14.8794,1
"1323",1,27,29,2,-17.0272451921103,-7.1826,-14.1206,9
"1324",1,19,9,-10,-18.8582470837777,4.8174,5.8794,1
"1325",1,15,22,7,-6.0066302767128,-12.1826,-7.1206,-3
"1326",1,16,4,-12,-17.7982617726773,6.8174,10.8794,-2
"1327",1,14,22,8,-4.46348203120548,-13.1826,-7.1206,-4
"1328",1,19,27,8,-8.15372035664824,-13.1826,-12.1206,1
"1329",1,17,25,8,-6.67864470766409,-13.1826,-10.1206,-1
"1330",1,17,12,-5,-14.5700811409121,-0.1826,2.8794,-1
"1331",1,18,2,-16,-21.7740728910199,10.8174,12.8794,0
"1332",1,23,27,4,-13.224264906149,-9.1826,-12.1206,5
"1333",1,20,27,7,-9.28584535778939,-12.1826,-12.1206,2
"1334",1,19,18,-1,-13.4910695865993,-4.1826,-3.1206,1
"1335",1,18,15,-3,-14.0679746896379,-2.1826,-0.1206,0
"1336",1,25,15,-10,-22.9277163865786,4.8174,-0.1206,7
"1337",1,16,23,7,-6.41809504378281,-12.1826,-8.1206,-2
"1338",1,16,16,0,-10.8427642034334,-5.1826,-1.1206,-2
"1339",1,18,11,-7,-16.2766379325986,1.8174,3.8794,0
"1340",1,14,30,16,0.494381093452599,-21.1826,-15.1206,-4
"1341",1,18,5,-13,-19.9487274356628,7.8174,9.8794,0
"1342",1,16,23,7,-6.84450568021824,-12.1826,-8.1206,-2
"1343",1,19,22,3,-11.3303524505792,-8.1826,-7.1206,1
"1344",1,21,28,7,-9.87932816841108,-12.1826,-13.1206,3
"1345",1,24,24,0,-16.2518520690659,-5.1826,-9.1206,6
"1346",1,22,17,-5,-17.8182817201274,-0.1826,-2.1206,4
"1347",1,19,14,-5,-15.7163693418675,-0.1826,0.8794,1
"1348",1,11,27,16,2.41379234168574,-21.1826,-12.1206,-7
"1349",1,23,0,-23,-29.2497624036436,17.8174,14.8794,5
"1350",1,20,19,-1,-13.8163461338047,-4.1826,-4.1206,2
"1351",1,25,27,2,-15.9862928188564,-7.1826,-12.1206,7
"1352",1,20,28,8,-8.9032118805851,-13.1826,-13.1206,2
"1353",1,25,25,0,-17.2038155574751,-5.1826,-10.1206,7
"1354",1,23,21,-2,-16.9525453879671,-3.1826,-6.1206,5
"1355",1,18,15,-3,-13.808753036689,-2.1826,-0.1206,0
"1356",1,20,8,-12,-20.8468975668174,6.8174,6.8794,2
"1357",1,18,24,6,-8.63239532366326,-11.1826,-9.1206,0
"1358",1,25,16,-9,-22.4906263298731,3.8174,-1.1206,7
"1359",1,16,21,5,-7.67604732901632,-10.1826,-6.1206,-2
"1360",1,20,17,-3,-15.2697294104692,-2.1826,-2.1206,2
"1361",1,13,26,13,-0.979312233238397,-18.1826,-11.1206,-5
"1362",1,21,28,7,-10.0424570554722,-12.1826,-13.1206,3
"1363",1,19,9,-10,-18.7049709923359,4.8174,5.8794,1
"1364",1,19,22,3,-11.1379630585981,-8.1826,-7.1206,1
"1365",1,22,28,6,-11.3103569382126,-11.1826,-13.1206,4
"1366",1,19,17,-2,-14.1191954701932,-3.1826,-2.1206,1
"1367",1,26,11,-15,-26.7162474033844,9.8174,3.8794,8
"1368",1,21,9,-12,-21.307982310722,6.8174,5.8794,3
"1369",1,29,1,-28,-36.3867619555984,22.8174,13.8794,11
"1370",1,20,2,-18,-24.124913686901,12.8174,12.8794,2
"1371",1,14,2,-12,-16.780757702036,6.8174,12.8794,-4
"1372",1,17,19,2,-10.3010543033399,-7.1826,-4.1206,-1
"1373",1,17,15,-2,-12.6590706478375,-3.1826,-0.1206,-1
"1374",1,21,27,6,-10.5002548793071,-11.1826,-12.1206,3
"1375",1,18,7,-11,-18.7982104338675,5.8174,7.8794,0
"1376",1,19,10,-9,-18.168260267648,3.8174,4.8794,1
"1377",1,19,2,-17,-22.9754969814387,11.8174,12.8794,1
"1378",1,31,0,-31,-39.6652228111178,25.8174,14.8794,13
"1379",1,12,7,-5,-10.8388303629818,-0.1826,7.8794,-6
"1380",1,15,4,-11,-16.4410263563769,5.8174,10.8794,-3
"1381",1,18,24,6,-8.3985932867538,-11.1826,-9.1206,0
"1382",1,20,2,-18,-24.4006316857428,12.8174,12.8794,2
"1383",1,18,5,-13,-19.7339374306184,7.8174,9.8794,0
"1384",1,16,5,-11,-17.2280760123383,5.8174,9.8794,-2
"1385",1,27,10,-17,-28.461113826552,11.8174,4.8794,9
"1386",1,21,25,4,-11.8382650069451,-9.1826,-10.1206,3
"1387",1,11,20,9,-1.91966472806174,-14.1826,-5.1206,-7
"1388",1,18,28,10,-6.04765242951649,-15.1826,-13.1206,0
"1389",1,24,19,-5,-19.3295730038716,-0.1826,-4.1206,6
"1390",1,15,6,-9,-15.4775242718108,3.8174,8.8794,-3
"1391",1,27,0,-27,-34.5106263037844,21.8174,14.8794,9
"1392",1,24,23,-1,-16.846444723418,-4.1826,-8.1206,6
"1393",1,20,29,9,-7.91356634407577,-14.1826,-14.1206,2
"1394",1,25,30,5,-14.215419637693,-10.1826,-15.1206,7
"1395",1,24,13,-11,-22.8947534390652,5.8174,1.8794,6
"1396",1,22,28,6,-11.327988930769,-11.1826,-13.1206,4
"1397",1,24,1,-23,-30.1844993884661,17.8174,13.8794,6
"1398",1,18,22,4,-9.74694257174518,-9.1826,-7.1206,0
"1399",1,19,24,5,-10.0700062557727,-10.1826,-9.1206,1
"1400",1,26,0,-26,-33.3167191963976,20.8174,14.8794,8
"1401",1,13,15,2,-7.5268178552341,-7.1826,-0.1206,-5
"1402",1,25,13,-12,-24.2208055222486,6.8174,1.8794,7
"1403",1,23,28,5,-12.5762567551774,-10.1826,-13.1206,5
"1404",1,15,5,-10,-15.8830428381085,4.8174,9.8794,-3
"1405",1,28,28,0,-19.0225787126005,-5.1826,-13.1206,10
"1406",1,21,17,-4,-16.4749457880118,-1.1826,-2.1206,3
"1407",1,23,0,-23,-29.5542355852451,17.8174,14.8794,5
"1408",1,16,22,6,-7.1104749620347,-11.1826,-7.1206,-2
"1409",1,20,17,-3,-15.0122806817615,-2.1826,-2.1206,2
"1410",1,16,0,-16,-20.1984648451759,10.8174,14.8794,-2
"1411",1,20,16,-4,-15.641857307616,-1.1826,-1.1206,2
"1412",1,18,16,-2,-13.2906882958008,-3.1826,-1.1206,0
"1413",1,22,19,-3,-16.6565896883641,-2.1826,-4.1206,4
"1414",1,14,24,10,-3.20511936055476,-15.1826,-9.1206,-4
"1415",1,20,20,0,-13.2452089717825,-5.1826,-5.1206,2
"1416",1,20,9,-11,-20.6333811750037,5.8174,5.8794,2
"1417",1,21,1,-20,-26.0858325341282,14.8174,13.8794,3
"1418",1,19,18,-1,-13.2919414178718,-4.1826,-3.1206,1
"1419",1,18,11,-7,-16.5203109264036,1.8174,3.8794,0
"1420",1,12,27,15,1.03250403107809,-20.1826,-12.1206,-6
"1421",1,19,11,-8,-17.6066121410465,2.8174,3.8794,1
"1422",1,21,4,-17,-24.4797917125639,11.8174,10.8794,3
"1423",1,23,10,-13,-23.5321852715331,7.8174,4.8794,5
"1424",1,32,2,-30,-39.9666644023465,24.8174,12.8794,14
"1425",1,29,1,-28,-36.5519566061987,22.8174,13.8794,11
"1426",1,13,18,5,-5.58825230254243,-10.1826,-3.1206,-5
"1427",1,16,4,-12,-17.8711416062764,6.8174,10.8794,-2
"1428",1,29,8,-21,-32.3756177837008,15.8174,6.8794,11
"1429",1,17,26,9,-6.14239912514633,-14.1826,-11.1206,-1
"1430",1,16,22,6,-7.11034500172592,-11.1826,-7.1206,-2
"1431",1,24,22,-2,-17.5767793571319,-3.1826,-7.1206,6
"1432",1,19,28,9,-7.31512321150894,-14.1826,-13.1206,1
"1433",1,17,26,9,-5.96035924419253,-14.1826,-11.1206,-1
"1434",1,22,15,-7,-18.7509469377779,1.8174,-0.1206,4
"1435",1,27,24,-3,-20.1122364013571,-2.1826,-9.1206,9
"1436",1,18,8,-10,-18.1761196855999,4.8174,6.8794,0
"1437",1,21,28,7,-10.1199286476123,-12.1826,-13.1206,3
"1438",1,18,4,-14,-20.5760946553246,8.8174,10.8794,0
"1439",1,20,24,4,-11.2458530974132,-9.1826,-9.1206,2
"1440",1,20,5,-15,-22.2936182243154,9.8174,9.8794,2
"1441",1,11,8,-3,-9.03525632917265,-2.1826,6.8794,-7
"1442",1,12,28,16,1.72516831038138,-21.1826,-13.1206,-6
"1443",1,20,13,-7,-17.6423017509128,1.8174,1.8794,2
"1444",1,20,10,-10,-19.5921634430622,4.8174,4.8794,2
"1445",1,22,23,1,-14.2112295424072,-6.1826,-8.1206,4
"1446",1,23,24,1,-14.8505960808988,-6.1826,-9.1206,5
"1447",1,23,18,-5,-18.8220305993032,-0.1826,-3.1206,5
"1448",1,21,0,-21,-26.8504205050928,15.8174,14.8794,3
"1449",1,17,14,-3,-13.0839016948008,-2.1826,0.8794,-1
"1450",1,32,13,-19,-33.3550956598065,13.8174,1.8794,14
"1451",1,19,11,-8,-17.5029960341751,2.8174,3.8794,1
"1452",1,23,20,-3,-17.4824261902216,-2.1826,-5.1206,5
"1453",1,25,17,-8,-21.7440670394885,2.8174,-2.1206,7
"1454",1,18,7,-11,-18.8638659771138,5.8174,7.8794,0
"1455",1,21,7,-14,-22.7925557130121,8.8174,7.8794,3
"1456",1,17,29,12,-4.24615677547947,-17.1826,-14.1206,-1
"1457",1,14,23,9,-3.6774676683746,-14.1826,-8.1206,-4
"1458",1,21,27,6,-10.4606484937788,-11.1826,-12.1206,3
"1459",1,16,5,-11,-17.3533146870401,5.8174,9.8794,-2
"1460",1,17,11,-6,-14.9413950838939,0.8174,3.8794,-1
"1461",1,12,6,-6,-11.6320303328522,0.8174,8.8794,-6
"1462",1,34,24,-10,-29.5415386653787,4.8174,-9.1206,16
"1463",1,14,20,6,-5.37899663371379,-11.1826,-5.1206,-4
"1464",1,29,15,-14,-28.2730831660984,8.8174,-0.1206,11
"1465",1,21,22,1,-13.4073302129021,-6.1826,-7.1206,3
"1466",1,28,26,-2,-20.1225749949045,-3.1826,-11.1206,10
"1467",1,22,6,-16,-24.276293003812,10.8174,8.8794,4
"1468",1,15,9,-6,-13.8154775796525,0.8174,5.8794,-3
"1469",1,22,16,-6,-18.2940693902572,0.8174,-1.1206,4
"1470",1,24,15,-9,-21.6968318941759,3.8174,-0.1206,6
"1471",1,25,14,-11,-23.6166326927588,5.8174,0.8794,7
"1472",1,24,24,0,-16.3249567249004,-5.1826,-9.1206,6
"1473",1,25,27,2,-15.774628863291,-7.1826,-12.1206,7
"1474",1,16,16,0,-10.5219845631078,-5.1826,-1.1206,-2
"1475",1,22,8,-14,-23.1230169339478,8.8174,6.8794,4
"1476",1,27,18,-9,-23.8188417018054,3.8174,-3.1206,9
"1477",1,17,15,-2,-12.5044357682959,-3.1826,-0.1206,-1
"1478",1,19,10,-9,-18.2511049457028,3.8174,4.8794,1
"1479",1,23,15,-8,-20.5335113742223,2.8174,-0.1206,5
"1480",1,24,14,-10,-22.5327902301767,4.8174,0.8794,6
"1481",1,19,21,2,-11.3710669101316,-7.1826,-6.1206,1
"1482",1,19,8,-11,-19.4571247350137,5.8174,6.8794,1
"1483",1,21,19,-2,-15.383435910355,-3.1826,-4.1206,3
"1484",1,26,7,-19,-28.7970509599909,13.8174,7.8794,8
"1485",1,20,15,-5,-16.3892972665817,-0.1826,-0.1206,2
"1486",1,20,18,-2,-14.5256048086684,-3.1826,-3.1206,2
"1487",1,17,18,1,-10.7518612088516,-6.1826,-3.1206,-1
"1488",1,22,4,-18,-25.6400792721582,12.8174,10.8794,4
"1489",1,19,18,-1,-13.4990756508749,-4.1826,-3.1206,1
"1490",1,21,9,-12,-21.3904056401537,6.8174,5.8794,3
"1491",1,27,3,-24,-32.7057124168495,18.8174,11.8794,9
"1492",1,16,25,9,-5.37628192684332,-14.1826,-10.1206,-2
"1493",1,22,17,-5,-17.9470999652081,-0.1826,-2.1206,4
"1494",1,20,17,-3,-15.2614587207532,-2.1826,-2.1206,2
"1495",1,12,5,-7,-11.9722363662624,1.8174,9.8794,-6
"1496",1,16,27,11,-4.20793198055985,-16.1826,-12.1206,-2
"1497",1,22,4,-18,-25.80266085285,12.8174,10.8794,4
"1498",1,17,11,-6,-15.0534367439879,0.8174,3.8794,-1
"1499",1,29,23,-6,-23.5168321916976,0.8174,-8.1206,11
"1500",1,19,3,-16,-22.3954398886249,10.8174,11.8794,1
"1501",1,28,12,-16,-28.8768742952774,10.8174,2.8794,10
"1502",1,25,4,-21,-29.5846634749434,15.8174,10.8794,7
"1503",1,15,5,-10,-15.9440414796323,4.8174,9.8794,-3
"1504",1,24,18,-6,-19.9093351358218,0.8174,-3.1206,6
"1505",1,15,15,0,-10.0558537736166,-5.1826,-0.1206,-3
"1506",1,20,5,-15,-22.5785760138928,9.8174,9.8794,2
"1507",1,19,5,-14,-21.1598422628962,8.8174,9.8794,1
"1508",1,18,1,-17,-22.3700705029648,11.8174,13.8794,0
"1509",1,14,19,5,-6.52326386644803,-10.1826,-4.1206,-4
"1510",1,19,5,-14,-21.0191054182718,8.8174,9.8794,1
"1511",1,18,0,-18,-23.0385765794977,12.8174,14.8794,0
"1512",1,20,28,8,-8.55666634596128,-13.1826,-13.1206,2
"1513",1,24,20,-4,-18.7782206555212,-1.1826,-5.1206,6
"1514",1,22,28,6,-11.0828556102125,-11.1826,-13.1206,4
"1515",1,24,8,-16,-25.8892803321638,10.8174,6.8794,6
"1516",1,24,11,-13,-23.9350284701194,7.8174,3.8794,6
"1517",1,20,17,-3,-15.4593086473598,-2.1826,-2.1206,2
"1518",1,19,24,5,-9.82109783507753,-10.1826,-9.1206,1
"1519",1,24,17,-7,-20.2080849050794,1.8174,-2.1206,6
"1520",1,17,17,0,-11.4775228901282,-5.1826,-2.1206,-1
"1521",1,13,29,16,0.948437870394523,-21.1826,-14.1206,-5
"1522",1,27,16,-11,-24.818887915066,5.8174,-1.1206,9
"1523",1,20,4,-16,-23.4912244155786,10.8174,10.8794,2
"1524",1,26,16,-10,-23.4966598480386,4.8174,-1.1206,8
"1525",1,20,7,-13,-21.11259715136,7.8174,7.8794,2
"1526",1,20,28,8,-8.91117835580482,-13.1826,-13.1206,2
"1527",1,13,20,7,-4.48537989839483,-12.1826,-5.1206,-5
"1528",1,19,6,-13,-20.5801543046171,7.8174,8.8794,1
"1529",1,15,16,1,-9.58710522768808,-6.1826,-1.1206,-3
"1530",1,25,24,-1,-17.4309889989356,-4.1826,-9.1206,7
"1531",1,24,12,-12,-23.4402394682767,6.8174,2.8794,6
"1532",1,19,7,-12,-20.0080502277633,6.8174,7.8794,1
"1533",1,27,16,-11,-25.1409590123626,5.8174,-1.1206,9
"1534",1,18,10,-8,-16.7467058590994,2.8174,4.8794,0
"1535",1,27,29,2,-17.2313094389483,-7.1826,-14.1206,9
"1536",1,17,1,-16,-20.9693940555127,10.8174,13.8794,-1
"1537",1,18,7,-11,-18.4522118619512,5.8174,7.8794,0
"1538",1,20,12,-8,-18.4866811859353,2.8174,2.8794,2
"1539",1,20,30,10,-7.53692362701482,-15.1826,-15.1206,2
"1540",1,18,30,12,-4.91286748071015,-17.1826,-15.1206,0
"1541",1,21,13,-8,-19.0747129776133,2.8174,1.8794,3
"1542",1,21,5,-16,-23.782024971201,10.8174,9.8794,3
"1543",1,14,20,6,-5.63640864423205,-11.1826,-5.1206,-4
"1544",1,17,5,-12,-18.6683928775036,6.8174,9.8794,-1
"1545",1,18,12,-6,-15.4420769297634,0.8174,2.8794,0
"1546",1,22,22,0,-15.1262928567883,-5.1826,-7.1206,4
"1547",1,21,13,-8,-19.2838349190304,2.8174,1.8794,3
"1548",1,18,19,1,-11.4398549962269,-6.1826,-4.1206,0
"1549",1,28,29,1,-18.1933850912782,-6.1826,-14.1206,10
"1550",1,30,12,-18,-31.3692664803383,12.8174,2.8794,12
"1551",1,14,4,-10,-15.163962401857,4.8174,10.8794,-4
"1552",1,18,15,-3,-13.6808815477027,-2.1826,-0.1206,0
"1553",1,27,6,-21,-31.231871952954,15.8174,8.8794,9
"1554",1,18,12,-6,-15.6526904483286,0.8174,2.8794,0
"1555",1,15,13,-2,-11.0750197064529,-3.1826,1.8794,-3
"1556",1,28,18,-10,-25.1610668060534,4.8174,-3.1206,10
"1557",1,22,13,-9,-20.3705923201851,3.8174,1.8794,4
"1558",1,16,21,5,-7.65743759322332,-10.1826,-6.1206,-2
"1559",1,13,7,-6,-12.1286287807727,0.8174,7.8794,-5
"1560",1,22,30,8,-10.302406274728,-13.1826,-15.1206,4
"1561",1,16,21,5,-7.80500973580166,-10.1826,-6.1206,-2
"1562",1,21,26,5,-11.0433181785439,-10.1826,-11.1206,3
"1563",1,15,8,-7,-14.1058463711972,1.8174,6.8794,-3
"1564",1,16,6,-10,-16.4882588589838,4.8174,8.8794,-2
"1565",1,29,23,-6,-23.3514766831627,0.8174,-8.1206,11
"1566",1,24,29,5,-13.3337058042941,-10.1826,-14.1206,6
"1567",1,17,1,-16,-21.006813566368,10.8174,13.8794,-1
"1568",1,17,25,8,-6.69619181835113,-13.1826,-10.1206,-1
"1569",1,18,25,7,-7.87601783973625,-12.1826,-10.1206,0
"1570",1,24,23,-1,-16.8736965345509,-4.1826,-8.1206,6
"1571",1,12,22,10,-1.99307917122245,-15.1826,-7.1206,-6
"1572",1,23,22,-1,-16.1166709434837,-4.1826,-7.1206,5
"1573",1,17,23,6,-7.88100740832152,-11.1826,-8.1206,-1
"1574",1,17,22,5,-8.57891829079406,-10.1826,-7.1206,-1
"1575",1,13,14,1,-8.09392073893731,-6.1826,0.8794,-5
"1576",1,20,25,5,-10.3844633884753,-10.1826,-10.1206,2
"1577",1,31,16,-15,-30.256041226029,9.8174,-1.1206,13
"1578",1,14,0,-14,-17.9775903768862,8.8174,14.8794,-4
"1579",1,21,13,-8,-19.02876352408,2.8174,1.8794,3
"1580",1,16,15,-1,-11.3021402435937,-4.1826,-0.1206,-2
"1581",1,20,9,-11,-20.0674062575732,5.8174,5.8794,2
"1582",1,15,20,5,-7.08406072015616,-10.1826,-5.1206,-3
"1583",1,23,3,-20,-27.6429531453843,14.8174,11.8794,5
"1584",1,18,1,-17,-22.2821107289577,11.8174,13.8794,0
"1585",1,26,19,-7,-21.6316030058989,1.8174,-4.1206,8
"1586",1,14,28,14,-1.02079724087675,-19.1826,-13.1206,-4
"1587",1,21,10,-11,-20.6863902198537,5.8174,4.8794,3
"1588",1,17,25,8,-6.74003841870196,-13.1826,-10.1206,-1
"1589",1,18,27,9,-6.71938855788588,-14.1826,-12.1206,0
"1590",1,9,12,3,-3.99465556746786,-8.1826,2.8794,-9
"1591",1,20,13,-7,-17.7356072852426,1.8174,1.8794,2
"1592",1,26,14,-12,-24.6471979283316,6.8174,0.8794,8
"1593",1,20,6,-14,-21.7219541056303,8.8174,8.8794,2
"1594",1,23,11,-12,-22.8863355537755,6.8174,3.8794,5
"1595",1,21,11,-10,-20.0848719534765,4.8174,3.8794,3
"1596",1,19,4,-15,-21.5887258758882,9.8174,10.8794,1
"1597",1,15,2,-13,-17.5676691713549,7.8174,12.8794,-3
"1598",1,27,4,-23,-32.6020815969423,17.8174,10.8794,9
"1599",1,22,18,-4,-17.1834103280534,-1.1826,-3.1206,4
"1600",1,25,28,3,-15.1745950140271,-8.1826,-13.1206,7
"1601",1,19,1,-18,-23.5992530674401,12.8174,13.8794,1
"1602",1,13,25,12,-1.35460446042832,-17.1826,-10.1206,-5
"1603",1,16,28,12,-3.4166769750203,-17.1826,-13.1206,-2
"1604",1,22,11,-11,-21.4013826423598,5.8174,3.8794,4
"1605",1,15,17,2,-8.71168018104886,-7.1826,-2.1206,-3
"1606",1,16,25,9,-5.25983411499693,-14.1826,-10.1206,-2
"1607",1,24,26,2,-14.8886318654346,-7.1826,-11.1206,6
"1608",1,20,14,-6,-17.1324674637276,0.8174,0.8794,2
"1609",1,18,20,2,-10.8731414757657,-7.1826,-5.1206,0
"1610",1,20,24,4,-10.8584622540837,-9.1826,-9.1206,2
"1611",1,15,0,-15,-19.0857049298843,9.8174,14.8794,-3
"1612",1,13,2,-11,-15.2236602304467,5.8174,12.8794,-5
"1613",1,20,20,0,-13.3843631582913,-5.1826,-5.1206,2
"1614",1,18,18,0,-12.2417265882553,-5.1826,-3.1206,0
"1615",1,19,9,-10,-18.5408092887867,4.8174,5.8794,1
"1616",1,16,0,-16,-20.7517577652574,10.8174,14.8794,-2
"1617",1,16,20,4,-8.16977786480706,-9.1826,-5.1206,-2
"1618",1,15,1,-14,-18.2587176309491,8.8174,13.8794,-3
"1619",1,18,26,8,-7.15005416057918,-13.1826,-11.1206,0
"1620",1,17,19,2,-10.4234027547479,-7.1826,-4.1206,-1
"1621",1,19,17,-2,-13.8376811466805,-3.1826,-2.1206,1
"1622",1,19,3,-16,-22.4234369609299,10.8174,11.8794,1
"1623",1,16,27,11,-4.0107095181969,-16.1826,-12.1206,-2
"1624",1,16,17,1,-10.0175034431977,-6.1826,-2.1206,-2
"1625",1,19,3,-16,-22.2332370755988,10.8174,11.8794,1
"1626",1,25,19,-6,-20.5452558114105,0.8174,-4.1206,7
"1627",1,28,18,-10,-25.0652159451637,4.8174,-3.1206,10
"1628",1,11,3,-8,-12.0037487794166,2.8174,11.8794,-7
"1629",1,25,12,-13,-24.5533755688612,7.8174,2.8794,7
"1630",1,19,9,-10,-18.6120925177027,4.8174,5.8794,1
"1631",1,14,8,-6,-13.0335336401119,0.8174,6.8794,-4
"1632",1,16,19,3,-8.64376816770375,-8.1826,-4.1206,-2
"1633",1,22,13,-9,-20.3977068155488,3.8174,1.8794,4
"1634",1,15,3,-12,-17.1561122541796,6.8174,11.8794,-3
"1635",1,18,19,1,-11.2841477653354,-6.1826,-4.1206,0
"1636",1,28,1,-27,-35.4139812093561,21.8174,13.8794,10
"1637",1,19,15,-4,-15.1932840037109,-1.1826,-0.1206,1
"1638",1,19,9,-10,-18.4229635780622,4.8174,5.8794,1
"1639",1,16,25,9,-5.13586126276094,-14.1826,-10.1206,-2
"1640",1,24,4,-20,-28.1584072519314,14.8174,10.8794,6
"1641",1,13,18,5,-5.31806899417795,-10.1826,-3.1206,-5
"1642",1,30,15,-15,-29.6848849536895,9.8174,-0.1206,12
"1643",1,21,0,-21,-26.7402423365439,15.8174,14.8794,3
"1644",1,18,28,10,-5.89614430028923,-15.1826,-13.1206,0
"1645",1,16,26,10,-4.83010637629352,-15.1826,-11.1206,-2
"1646",1,19,10,-9,-18.1863899891575,3.8174,4.8794,1
"1647",1,26,6,-20,-29.7790749126083,14.8174,8.8794,8
"1648",1,19,1,-18,-23.7150473898957,12.8174,13.8794,1
"1649",1,10,15,5,-3.52437144026252,-10.1826,-0.1206,-8
"1650",1,23,1,-22,-28.8989015989631,16.8174,13.8794,5
"1651",1,16,4,-12,-17.9768745589083,6.8174,10.8794,-2
"1652",1,16,24,8,-5.82922544038857,-13.1826,-9.1206,-2
"1653",1,13,20,7,-4.23110071810109,-12.1826,-5.1206,-5
"1654",1,22,12,-10,-20.9712754912827,4.8174,2.8794,4
"1655",1,21,5,-16,-23.6952397264468,10.8174,9.8794,3
"1656",1,25,9,-16,-26.91903302784,10.8174,5.8794,7
"1657",1,19,10,-9,-18.2686222235193,3.8174,4.8794,1
"1658",1,23,9,-14,-23.9542493899373,8.8174,5.8794,5
"1659",1,22,8,-14,-23.2433845498797,8.8174,6.8794,4
"1660",1,16,20,4,-8.34068505934076,-9.1826,-5.1206,-2
"1661",1,28,5,-23,-32.9000740220882,17.8174,9.8794,10
"1662",1,13,9,-4,-11.1240639451872,-1.1826,5.8794,-5
"1663",1,20,1,-19,-24.7295848499831,13.8174,13.8794,2
"1664",1,19,2,-17,-22.9731096606724,11.8174,12.8794,1
"1665",1,12,21,9,-2.45609552243232,-14.1826,-6.1206,-6
"1666",1,21,20,-1,-14.849463192696,-4.1826,-5.1206,3
"1667",1,22,11,-11,-21.5784932946508,5.8174,3.8794,4
"1668",1,20,9,-11,-20.1083990598835,5.8174,5.8794,2
"1669",1,25,13,-12,-24.3478529251666,6.8174,1.8794,7
"1670",1,26,16,-10,-23.4929719956483,4.8174,-1.1206,8
"1671",1,20,18,-2,-14.7276922829673,-3.1826,-3.1206,2
"1672",1,24,25,1,-15.8590396448973,-6.1826,-10.1206,6
"1673",1,17,6,-11,-18.1256398453591,5.8174,8.8794,-1
"1674",1,27,5,-22,-31.4959073267352,16.8174,9.8794,9
"1675",1,30,20,-10,-26.5056469954049,4.8174,-5.1206,12
"1676",1,29,10,-19,-31.4020710218646,13.8174,4.8794,11
"1677",1,19,1,-18,-23.5924021045544,12.8174,13.8794,1
"1678",1,24,3,-21,-29.040302071455,15.8174,11.8794,6
"1679",1,19,13,-6,-16.4348011431499,0.8174,1.8794,1
"1680",1,28,6,-22,-32.2808898185898,16.8174,8.8794,10
"1681",1,13,19,6,-5.01449908015229,-11.1826,-4.1206,-5
"1682",1,22,23,1,-14.1553520556472,-6.1826,-8.1206,4
"1683",1,14,14,0,-9.23512994636471,-5.1826,0.8794,-4
"1684",1,29,19,-10,-25.7290994218534,4.8174,-4.1206,11
"1685",1,22,27,5,-11.7188165613152,-10.1826,-12.1206,4
"1686",1,10,11,1,-5.80571444227538,-6.1826,3.8794,-8
"1687",1,14,20,6,-5.65122210327174,-11.1826,-5.1206,-4
"1688",1,23,30,7,-11.3232811016778,-12.1826,-15.1206,5
"1689",1,18,1,-17,-22.4282034292547,11.8174,13.8794,0
"1690",1,17,2,-15,-20.5711949253008,9.8174,12.8794,-1
"1691",1,24,22,-2,-17.7571301292515,-3.1826,-7.1206,6
"1692",1,16,22,6,-7.11448510342409,-11.1826,-7.1206,-2
"1693",1,21,9,-12,-21.5067252998985,6.8174,5.8794,3
"1694",1,18,5,-13,-19.8173464666757,7.8174,9.8794,0
"1695",1,13,5,-8,-13.2297343059463,2.8174,9.8794,-5
"1696",1,31,6,-25,-35.8071874675554,19.8174,8.8794,13
"1697",1,25,3,-22,-30.3080749677801,16.8174,11.8794,7
"1698",1,15,30,15,-1.09246023654007,-20.1826,-15.1206,-3
"1699",1,16,17,1,-9.88821440647116,-6.1826,-2.1206,-2
"1700",1,14,7,-7,-13.536116532349,1.8174,7.8794,-4
"1701",1,17,12,-5,-14.4347326071393,-0.1826,2.8794,-1
"1702",1,18,28,10,-6.10779823027526,-15.1826,-13.1206,0
"1703",1,17,16,-1,-11.9934768138675,-4.1826,-1.1206,-1
"1704",1,17,21,4,-9.07736273166052,-9.1826,-6.1206,-1
"1705",1,21,9,-12,-21.5067180516578,6.8174,5.8794,3
"1706",1,23,24,1,-15.0352615506111,-6.1826,-9.1206,5
"1707",1,17,4,-13,-19.4970055821239,7.8174,10.8794,-1
"1708",1,20,14,-6,-17.2555679240905,0.8174,0.8794,2
"1709",1,8,10,2,-3.82035630810883,-7.1826,4.8794,-10
"1710",1,31,13,-18,-31.9630744404571,12.8174,1.8794,13
"1711",1,19,13,-6,-16.3770652710613,0.8174,1.8794,1
"1712",1,24,7,-17,-26.5962848419067,11.8174,7.8794,6
"1713",1,20,27,7,-9.45109824283048,-12.1826,-12.1206,2
"1714",1,20,17,-3,-15.3714078341065,-2.1826,-2.1206,2
"1715",1,17,13,-4,-13.8627413113472,-1.1826,1.8794,-1
"1716",1,21,0,-21,-26.8006336956397,15.8174,14.8794,3
"1717",1,29,6,-23,-33.6134280298219,17.8174,8.8794,11
"1718",1,17,9,-8,-16.272633253514,2.8174,5.8794,-1
"1719",1,23,14,-9,-20.9189014367206,3.8174,0.8794,5
"1720",1,12,29,17,2.22639318105401,-22.1826,-14.1206,-6
"1721",1,25,23,-2,-17.9652822804354,-3.1826,-8.1206,7
"1722",1,17,2,-15,-20.2665342924274,9.8174,12.8794,-1
"1723",1,17,9,-8,-16.4884321204005,2.8174,5.8794,-1
"1724",1,17,3,-14,-19.9944762484882,8.8174,11.8794,-1
"1725",1,23,8,-15,-24.5918491369355,9.8174,6.8794,5
"1726",1,19,8,-11,-19.3220194145372,5.8174,6.8794,1
"1727",1,20,0,-20,-25.5770634127684,14.8174,14.8794,2
"1728",1,25,3,-22,-30.0888077228258,16.8174,11.8794,7
"1729",1,22,7,-15,-23.917775908969,9.8174,7.8794,4
"1730",1,24,22,-2,-17.1944804452707,-3.1826,-7.1206,6
"1731",1,22,14,-8,-19.6043975906756,2.8174,0.8794,4
"1732",1,24,20,-4,-18.6326560073404,-1.1826,-5.1206,6
"1733",1,15,26,11,-3.77486834233006,-16.1826,-11.1206,-3
"1734",1,14,10,-4,-11.6819595911923,-1.1826,4.8794,-4
"1735",1,18,9,-9,-17.3338837687283,3.8174,5.8794,0
"1736",1,23,6,-17,-26.0374928461903,11.8174,8.8794,5
"1737",1,15,16,1,-9.22998350303329,-6.1826,-1.1206,-3
"1738",1,13,7,-6,-12.558766831985,0.8174,7.8794,-5
"1739",1,29,20,-9,-25.0501403921548,3.8174,-5.1206,11
"1740",1,14,29,15,-0.504904784559021,-20.1826,-14.1206,-4
"1741",1,25,2,-23,-30.9510442816295,17.8174,12.8794,7
"1742",1,15,11,-4,-12.3485370280902,-1.1826,3.8794,-3
"1743",1,23,12,-11,-22.0141273693755,5.8174,2.8794,5
"1744",1,15,10,-5,-13.0997426212819,-0.1826,4.8794,-3
"1745",1,13,17,4,-6.1546197594163,-9.1826,-2.1206,-5
"1746",1,23,28,5,-12.8516620842881,-10.1826,-13.1206,5
"1747",1,10,15,5,-3.25245004517542,-10.1826,-0.1206,-8
"1748",1,18,18,0,-12.2552452231252,-5.1826,-3.1206,0
"1749",1,23,10,-13,-23.5100566695564,7.8174,4.8794,5
"1750",1,16,27,11,-4.03380770450525,-16.1826,-12.1206,-2
"1751",1,16,7,-9,-16.2907516931744,3.8174,7.8794,-2
"1752",1,18,29,11,-5.51041509594319,-16.1826,-14.1206,0
"1753",1,21,30,9,-8.69787661648153,-14.1826,-15.1206,3
"1754",1,18,23,5,-8.99233497180758,-10.1826,-8.1206,0
"1755",1,15,8,-7,-14.2135620139359,1.8174,6.8794,-3
"1756",1,22,29,7,-10.6376728814779,-12.1826,-14.1206,4
"1757",1,23,3,-20,-27.6710842846458,14.8174,11.8794,5
"1758",1,15,12,-3,-11.7724252728573,-2.1826,2.8794,-3
"1759",1,23,7,-16,-25.2811067849938,10.8174,7.8794,5
"1760",1,15,25,10,-3.80629276851367,-15.1826,-10.1206,-3
"1761",1,16,9,-7,-14.7812843663388,1.8174,5.8794,-2
"1762",1,14,9,-5,-12.5286949555687,-0.1826,5.8794,-4
"1763",1,21,24,3,-12.3660489289929,-8.1826,-9.1206,3
"1764",1,17,19,2,-9.90387436875263,-7.1826,-4.1206,-1
"1765",1,18,27,9,-6.77367683693647,-14.1826,-12.1206,0
"1766",1,16,18,2,-9.4615533528978,-7.1826,-3.1206,-2
"1767",1,19,18,-1,-13.2137200848456,-4.1826,-3.1206,1
"1768",1,18,15,-3,-13.7610802432831,-2.1826,-0.1206,0
"1769",1,16,27,11,-4.09378884255669,-16.1826,-12.1206,-2
"1770",1,20,13,-7,-17.5185377618545,1.8174,1.8794,2
"1771",1,24,27,3,-14.6381286040414,-8.1826,-12.1206,6
"1772",1,22,20,-2,-16.1029364489263,-3.1826,-5.1206,4
"1773",1,25,26,1,-16.3125400475965,-6.1826,-11.1206,7
"1774",1,11,10,-1,-7.75953733864047,-4.1826,4.8794,-7
"1775",1,19,11,-8,-17.58363880089,2.8174,3.8794,1
"1776",1,24,13,-11,-22.7293058260068,5.8174,1.8794,6
"1777",1,24,18,-6,-19.7782678340523,0.8174,-3.1206,6
"1778",1,23,26,3,-13.7923497346423,-8.1826,-11.1206,5
"1779",1,16,19,3,-8.82417554021834,-8.1826,-4.1206,-2
"1780",1,19,19,0,-12.4297837202813,-5.1826,-4.1206,1
"1781",1,20,2,-18,-24.195221325586,12.8174,12.8794,2
"1782",1,24,21,-3,-18.3339930509105,-2.1826,-6.1206,6
"1783",1,18,25,7,-7.84199132102757,-12.1826,-10.1206,0
"1784",1,30,5,-25,-35.506711604485,19.8174,9.8794,12
"1785",1,13,15,2,-7.19607046307619,-7.1826,-0.1206,-5
"1786",1,22,12,-10,-20.8069255675831,4.8174,2.8794,4
"1787",1,22,5,-17,-25.3016868509613,11.8174,9.8794,4
"1788",1,22,20,-2,-15.7876602542568,-3.1826,-5.1206,4
"1789",1,19,22,3,-10.927540163784,-8.1826,-7.1206,1
"1790",1,20,19,-1,-13.8458146553896,-4.1826,-4.1206,2
"1791",1,18,30,12,-4.95345834587436,-17.1826,-15.1206,0
"1792",1,18,15,-3,-13.9044903644071,-2.1826,-0.1206,0
"1793",1,24,19,-5,-19.0991158135651,-0.1826,-4.1206,6
"1794",1,19,0,-19,-24.0305652817717,13.8174,14.8794,1
"1795",1,22,24,2,-13.5906362790817,-7.1826,-9.1206,4
"1796",1,15,21,6,-6.46136614739573,-11.1826,-6.1206,-3
"1797",1,24,29,5,-13.2327380062833,-10.1826,-14.1206,6
"1798",1,23,8,-15,-24.59355944476,9.8174,6.8794,5
"1799",1,25,26,1,-16.3026595673149,-6.1826,-11.1206,7
"1800",1,24,21,-3,-18.0754674330248,-2.1826,-6.1206,6
"1801",1,25,2,-23,-30.8370803178595,17.8174,12.8794,7
"1802",1,12,6,-6,-11.449269024506,0.8174,8.8794,-6
"1803",1,28,29,1,-18.5295600496732,-6.1826,-14.1206,10
"1804",1,20,10,-10,-19.279150027846,4.8174,4.8794,2
"1805",1,21,7,-14,-22.5202908561277,8.8174,7.8794,3
"1806",1,14,7,-7,-13.5966011959765,1.8174,7.8794,-4
"1807",1,22,1,-21,-27.5827785155878,15.8174,13.8794,4
"1808",1,24,18,-6,-19.8027156111162,0.8174,-3.1206,6
"1809",1,15,6,-9,-15.4927948879852,3.8174,8.8794,-3
"1810",1,19,25,6,-9.09186964227699,-11.1826,-10.1206,1
"1811",1,19,30,11,-6.38259056222639,-16.1826,-15.1206,1
"1812",1,29,2,-27,-36.2072788718678,21.8174,12.8794,11
"1813",1,21,16,-5,-17.31364178339,-0.1826,-1.1206,3
"1814",1,21,15,-6,-17.860136964185,0.8174,-0.1206,3
"1815",1,25,30,5,-13.7772308509424,-10.1826,-15.1206,7
"1816",1,22,26,4,-12.4567205582809,-9.1826,-11.1206,4
"1817",1,25,9,-16,-26.7660876120046,10.8174,5.8794,7
"1818",1,18,1,-17,-22.220420469555,11.8174,13.8794,0
"1819",1,16,2,-14,-19.0926315218035,8.8174,12.8794,-2
"1820",1,10,6,-4,-8.88113464611941,-1.1826,8.8794,-8
"1821",1,21,1,-20,-26.2285547108414,14.8174,13.8794,3
"1822",1,19,15,-4,-15.3041561140971,-1.1826,-0.1206,1
"1823",1,17,21,4,-8.8987366472674,-9.1826,-6.1206,-1
"1824",1,21,1,-20,-26.386229957213,14.8174,13.8794,3
"1825",1,19,19,0,-12.8282208961572,-5.1826,-4.1206,1
"1826",1,23,20,-3,-17.1497594576392,-2.1826,-5.1206,5
"1827",1,21,8,-13,-22.2651839773709,7.8174,6.8794,3
"1828",1,24,11,-13,-24.086124803154,7.8174,3.8794,6
"1829",1,26,27,1,-16.8386296593075,-6.1826,-12.1206,8
"1830",1,17,18,1,-10.8411151782106,-6.1826,-3.1206,-1
"1831",1,27,27,0,-18.4021482124139,-5.1826,-12.1206,9
"1832",1,20,16,-4,-16.2145617018313,-1.1826,-1.1206,2
"1833",1,18,9,-9,-17.5604098835858,3.8174,5.8794,0
"1834",1,18,26,8,-7.31633850941829,-13.1826,-11.1206,0
"1835",1,17,16,-1,-12.3178294732558,-4.1826,-1.1206,-1
"1836",1,15,0,-15,-18.9861778258686,9.8174,14.8794,-3
"1837",1,22,14,-8,-19.682143185578,2.8174,0.8794,4
"1838",1,21,24,3,-12.4673723145434,-8.1826,-9.1206,3
"1839",1,16,29,13,-2.92483051207702,-18.1826,-14.1206,-2
"1840",1,19,13,-6,-16.4464129046525,0.8174,1.8794,1
"1841",1,16,17,1,-10.1743649825411,-6.1826,-2.1206,-2
"1842",1,18,22,4,-9.76225046641897,-9.1826,-7.1206,0
"1843",1,26,10,-16,-27.1424937528438,10.8174,4.8794,8
"1844",1,12,21,9,-2.71806158667606,-14.1826,-6.1206,-6
"1845",1,21,9,-12,-21.4542231603817,6.8174,5.8794,3
"1846",1,20,22,2,-12.1373746386254,-7.1826,-7.1206,2
"1847",1,15,26,11,-3.41972958177095,-16.1826,-11.1206,-3
"1848",1,27,27,0,-18.8041907420633,-5.1826,-12.1206,9
"1849",1,14,17,3,-7.45707003358446,-8.1826,-2.1206,-4
"1850",1,26,26,0,-17.8055073665172,-5.1826,-11.1206,8
"1851",1,21,16,-5,-17.1076286336799,-0.1826,-1.1206,3
"1852",1,19,16,-3,-14.6036093776398,-2.1826,-1.1206,1
"1853",1,21,8,-13,-22.2065039640115,7.8174,6.8794,3
"1854",1,17,5,-12,-18.7608317478427,6.8174,9.8794,-1
"1855",1,22,30,8,-10.0457384265832,-13.1826,-15.1206,4
"1856",1,17,3,-14,-19.6856706544986,8.8174,11.8794,-1
"1857",1,25,8,-17,-27.2689433090043,11.8174,6.8794,7
"1858",1,19,21,2,-11.7643477600455,-7.1826,-6.1206,1
"1859",1,22,9,-13,-22.6673522614354,7.8174,5.8794,4
"1860",1,22,12,-10,-20.9365170852444,4.8174,2.8794,4
"1861",1,24,20,-4,-18.5382555934491,-1.1826,-5.1206,6
"1862",1,23,16,-7,-19.8362437087753,1.8174,-1.1206,5
"1863",1,25,5,-20,-29.1266716213459,14.8174,9.8794,7
"1864",1,15,19,4,-7.30049697334449,-9.1826,-4.1206,-3
"1865",1,23,23,0,-15.6574152822539,-5.1826,-8.1206,5
"1866",1,17,23,6,-8.07380903516839,-11.1826,-8.1206,-1
"1867",1,26,6,-20,-29.7122629281084,14.8174,8.8794,8
"1868",1,23,9,-14,-24.1250367122791,8.8174,5.8794,5
"1869",1,17,9,-8,-16.2174340763016,2.8174,5.8794,-1
"1870",1,17,16,-1,-12.0074497382033,-4.1826,-1.1206,-1
"1871",1,14,12,-2,-10.1717801264227,-3.1826,2.8794,-4
"1872",1,27,29,2,-16.9396958990934,-7.1826,-14.1206,9
"1873",1,18,27,9,-6.81386961695687,-14.1826,-12.1206,0
"1874",1,17,12,-5,-14.3116318253453,-0.1826,2.8794,-1
"1875",1,27,30,3,-16.7946531142522,-8.1826,-15.1206,9
"1876",1,12,27,15,1.05005681146329,-20.1826,-12.1206,-6
"1877",1,15,21,6,-6.29932680020386,-11.1826,-6.1206,-3
"1878",1,22,20,-2,-15.8789079668328,-3.1826,-5.1206,4
"1879",1,12,30,18,2.97921042025506,-23.1826,-15.1206,-6
"1880",1,17,27,10,-5.41943289585531,-15.1826,-12.1206,-1
"1881",1,20,3,-17,-23.9889550773509,11.8174,11.8794,2
"1882",1,17,28,11,-4.6383875023865,-16.1826,-13.1206,-1
"1883",1,26,12,-14,-25.9784799389766,8.8174,2.8794,8
"1884",1,26,5,-21,-30.3334898872993,15.8174,9.8794,8
"1885",1,25,6,-19,-28.3365277001238,13.8174,8.8794,7
"1886",1,21,10,-11,-20.7467914115051,5.8174,4.8794,3
"1887",1,18,21,3,-10.4586213736857,-8.1826,-6.1206,0
"1888",1,19,19,0,-12.8256084038169,-5.1826,-4.1206,1
"1889",1,29,13,-16,-29.3983907757829,10.8174,1.8794,11
"1890",1,26,14,-12,-24.5592779184188,6.8174,0.8794,8
"1891",1,28,8,-20,-30.9990980040943,14.8174,6.8794,10
"1892",1,15,14,-1,-10.4882033712262,-4.1826,0.8794,-3
"1893",1,16,18,2,-9.5470247931802,-7.1826,-3.1206,-2
"1894",1,25,5,-20,-29.336454498269,14.8174,9.8794,7
"1895",1,20,22,2,-12.29070850175,-7.1826,-7.1206,2
"1896",1,17,29,12,-4.31751235137019,-17.1826,-14.1206,-1
"1897",1,21,13,-8,-18.845025404393,2.8174,1.8794,3
"1898",1,17,9,-8,-16.3350981723487,2.8174,5.8794,-1
"1899",1,18,0,-18,-23.1043065204758,12.8174,14.8794,0
"1900",1,18,22,4,-9.7468896461217,-9.1826,-7.1206,0
"1901",1,24,7,-17,-26.4205921505529,11.8174,7.8794,6
"1902",1,29,1,-28,-36.5040302538254,22.8174,13.8794,11
"1903",1,14,29,15,-0.327122717199455,-20.1826,-14.1206,-4
"1904",1,14,12,-2,-10.9085686661319,-3.1826,2.8794,-4
"1905",1,16,13,-3,-12.6580473558538,-2.1826,1.8794,-2
"1906",1,28,17,-11,-25.9213802205247,5.8174,-2.1206,10
"1907",1,18,20,2,-10.9618593943776,-7.1826,-5.1206,0
"1908",1,23,9,-14,-24.1188695870381,8.8174,5.8794,5
"1909",1,22,7,-15,-23.8228894077969,9.8174,7.8794,4
"1910",1,29,20,-9,-25.0008804521916,3.8174,-5.1206,11
"1911",1,28,8,-20,-30.9822687452355,14.8174,6.8794,10
"1912",1,20,2,-18,-24.2657071320471,12.8174,12.8794,2
"1913",1,18,8,-10,-17.9033975688719,4.8174,6.8794,0
"1914",1,22,11,-11,-21.6523088927501,5.8174,3.8794,4
"1915",1,23,22,-1,-16.5255389800226,-4.1826,-7.1206,5
"1916",1,13,12,-1,-9.20726873110603,-4.1826,2.8794,-5
"1917",1,12,11,-1,-8.62773396336485,-4.1826,3.8794,-6
"1918",1,20,26,6,-10.14201782243,-11.1826,-11.1206,2
"1919",1,18,22,4,-9.76802358062503,-9.1826,-7.1206,0
"1920",1,22,24,2,-13.6999073508788,-7.1826,-9.1206,4
"1921",1,23,23,0,-15.4384981578062,-5.1826,-8.1206,5
"1922",1,20,4,-16,-22.9220054526372,10.8174,10.8794,2
"1923",1,25,29,4,-14.5648116600724,-9.1826,-14.1206,7
"1924",1,17,25,8,-6.91081481440499,-13.1826,-10.1206,-1
"1925",1,19,6,-13,-20.7882920475545,7.8174,8.8794,1
"1926",1,15,2,-13,-17.6432741933078,7.8174,12.8794,-3
"1927",1,21,27,6,-10.4058762264995,-11.1826,-12.1206,3
"1928",1,18,3,-15,-21.0710610587336,9.8174,11.8794,0
"1929",1,19,25,6,-9.20840460990177,-11.1826,-10.1206,1
"1930",1,14,2,-12,-16.67102073293,6.8174,12.8794,-4
"1931",1,25,10,-15,-26.0797330365858,9.8174,4.8794,7
"1932",1,19,5,-14,-21.0147770658456,8.8174,9.8794,1
"1933",1,16,7,-9,-16.1213294357721,3.8174,7.8794,-2
"1934",1,23,1,-22,-29.0383681229936,16.8174,13.8794,5
"1935",1,17,7,-10,-17.5394098990551,4.8174,7.8794,-1
"1936",1,17,10,-7,-15.6411154818109,1.8174,4.8794,-1
"1937",1,20,0,-20,-25.4721252672525,14.8174,14.8794,2
"1938",1,20,20,0,-13.6841112862993,-5.1826,-5.1206,2
"1939",1,18,22,4,-9.52692139176522,-9.1826,-7.1206,0
"1940",1,16,15,-1,-11.6068547658149,-4.1826,-0.1206,-2
"1941",1,28,2,-26,-34.7434976763708,20.8174,12.8794,10
"1942",1,16,20,4,-8.30343400605203,-9.1826,-5.1206,-2
"1943",1,17,11,-6,-15.0131833026295,0.8174,3.8794,-1
"1944",1,24,19,-5,-19.3819481694047,-0.1826,-4.1206,6
"1945",1,14,27,13,-1.56801949745877,-18.1826,-12.1206,-4
"1946",1,10,13,3,-4.71028361985217,-8.1826,1.8794,-8
"1947",1,20,17,-3,-15.1364676083959,-2.1826,-2.1206,2
"1948",1,25,25,0,-16.9225473770259,-5.1826,-10.1206,7
"1949",1,26,19,-7,-21.6917933625362,1.8174,-4.1206,8
"1950",1,22,0,-22,-27.9148606932972,16.8174,14.8794,4
"1951",1,20,3,-17,-23.5547883921718,11.8174,11.8794,2
"1952",1,13,8,-5,-11.6284548911313,-0.1826,6.8794,-5
"1953",1,24,23,-1,-17.1475500895032,-4.1826,-8.1206,6
"1954",1,16,0,-16,-20.4110644388862,10.8174,14.8794,-2
"1955",1,16,4,-12,-17.8289117686839,6.8174,10.8794,-2
"1956",1,26,12,-14,-26.0570948555135,8.8174,2.8794,8
"1957",1,19,10,-9,-18.1569939484053,3.8174,4.8794,1
"1958",1,22,7,-15,-23.9648020594733,9.8174,7.8794,4
"1959",1,16,14,-2,-12.2503562832726,-3.1826,0.8794,-2
"1960",1,22,12,-10,-20.7846995204155,4.8174,2.8794,4
"1961",1,16,3,-13,-18.6717447526963,7.8174,11.8794,-2
"1962",1,27,24,-3,-20.2780973822787,-2.1826,-9.1206,9
"1963",1,22,16,-6,-18.4852894779121,0.8174,-1.1206,4
"1964",1,29,18,-11,-26.7105648941248,5.8174,-3.1206,11
"1965",1,19,25,6,-9.18383036205772,-11.1826,-10.1206,1
"1966",1,22,19,-3,-16.6089495095769,-2.1826,-4.1206,4
"1967",1,25,11,-14,-25.2919739924175,8.8174,3.8794,7
"1968",1,17,19,2,-10.2157510972506,-7.1826,-4.1206,-1
"1969",1,25,13,-12,-24.0578876753849,6.8174,1.8794,7
"1970",1,12,30,18,2.78519485883145,-23.1826,-15.1206,-6
"1971",1,21,28,7,-9.98384812824336,-12.1826,-13.1206,3
"1972",1,27,27,0,-18.392128868316,-5.1826,-12.1206,9
"1973",1,23,7,-16,-25.0127794505302,10.8174,7.8794,5
"1974",1,22,28,6,-11.1017582282861,-11.1826,-13.1206,4
"1975",1,32,1,-31,-40.3148466033314,25.8174,13.8794,14
"1976",1,18,9,-9,-17.6941800644463,3.8174,5.8794,0
"1977",1,20,7,-13,-21.3981592664867,7.8174,7.8794,2
"1978",1,21,17,-4,-16.4782868235013,-1.1826,-2.1206,3
"1979",1,19,19,0,-12.5263336227231,-5.1826,-4.1206,1
"1980",1,18,8,-10,-18.0164388308886,4.8174,6.8794,0
"1981",1,15,1,-14,-18.4334530678412,8.8174,13.8794,-3
"1982",1,14,3,-11,-16.1170287455317,5.8174,11.8794,-4
"1983",1,17,5,-12,-18.5946415857187,6.8174,9.8794,-1
"1984",1,33,27,-6,-25.8822612692817,0.8174,-12.1206,15
"1985",1,21,20,-1,-14.8428167887319,-4.1826,-5.1206,3
"1986",1,30,23,-7,-24.5562709011103,1.8174,-8.1206,12
"1987",1,25,15,-10,-22.93324240223,4.8174,-0.1206,7
"1988",1,17,18,1,-10.8932316156179,-6.1826,-3.1206,-1
"1989",1,16,27,11,-4.23932960511041,-16.1826,-12.1206,-2
"1990",1,13,19,6,-5.10645598790326,-11.1826,-4.1206,-5
"1991",1,22,16,-6,-18.6740006698975,0.8174,-1.1206,4
"1992",1,18,4,-14,-20.4182455369871,8.8174,10.8794,0
"1993",1,24,9,-15,-25.2253702927971,9.8174,5.8794,6
"1994",1,21,7,-14,-22.7367921412835,8.8174,7.8794,3
"1995",1,18,2,-16,-21.8290207381512,10.8174,12.8794,0
"1996",1,18,9,-9,-17.622084165077,3.8174,5.8794,0
"1997",1,19,19,0,-12.5229311816258,-5.1826,-4.1206,1
"1998",1,33,16,-17,-32.6718200075873,11.8174,-1.1206,15
"1999",1,15,3,-12,-17.2193960484387,6.8174,11.8794,-3
"2000",1,11,11,0,-7.07181913311232,-5.1826,3.8794,-7
"2001",1,24,27,3,-14.6755573478397,-8.1826,-12.1206,6
"2002",1,24,5,-19,-27.6600002500078,13.8174,9.8794,6
"2003",1,18,28,10,-6.15744267682762,-15.1826,-13.1206,0
"2004",1,24,14,-10,-22.4104115163005,4.8174,0.8794,6
"2005",1,22,6,-16,-24.5569227756466,10.8174,8.8794,4
"2006",1,24,2,-22,-29.6070886238128,16.8174,12.8794,6
"2007",1,16,9,-7,-14.7756848479942,1.8174,5.8794,-2
"2008",1,23,25,2,-14.3943513370765,-7.1826,-10.1206,5
"2009",1,19,16,-3,-14.7613003777271,-2.1826,-1.1206,1
"2010",1,15,11,-4,-12.110521855593,-1.1826,3.8794,-3
"2011",1,21,8,-13,-22.0804878935395,7.8174,6.8794,3
"2012",1,17,13,-4,-14.0412936866312,-1.1826,1.8794,-1
"2013",1,19,20,1,-12.1945679373034,-6.1826,-5.1206,1
"2014",1,16,10,-6,-14.2776900982337,0.8174,4.8794,-2
"2015",1,29,7,-22,-33.2184527984969,16.8174,7.8794,11
"2016",1,21,1,-20,-26.4798150507391,14.8174,13.8794,3
"2017",1,13,25,12,-1.66167823021188,-17.1826,-10.1206,-5
"2018",1,18,21,3,-10.2199284353841,-8.1826,-6.1206,0
"2019",1,19,21,2,-11.5727249412757,-7.1826,-6.1206,1
"2020",1,12,15,3,-6.3849585104152,-8.1826,-0.1206,-6
"2021",1,22,21,-1,-15.4412276363621,-4.1826,-6.1206,4
"2022",1,25,21,-4,-19.5005316509935,-1.1826,-6.1206,7
"2023",1,15,23,8,-5.09368481878662,-13.1826,-8.1206,-3
"2024",1,14,0,-14,-17.8026401309571,8.8174,14.8794,-4
"2025",1,27,20,-7,-22.7750585457026,1.8174,-5.1206,9
"2026",1,26,30,4,-15.6201589027921,-9.1826,-15.1206,8
"2027",1,17,3,-14,-19.7694312505392,8.8174,11.8794,-1
"2028",1,20,10,-10,-19.6789616873712,4.8174,4.8794,2
"2029",1,20,15,-5,-16.4191006441827,-0.1826,-0.1206,2
"2030",1,19,19,0,-12.6042685122612,-5.1826,-4.1206,1
"2031",1,21,4,-17,-24.4310580543218,11.8174,10.8794,3
"2032",1,19,5,-14,-21.1570635377026,8.8174,9.8794,1
"2033",1,17,21,4,-9.10083515443914,-9.1826,-6.1206,-1
"2034",1,24,26,2,-15.2691757030595,-7.1826,-11.1206,6
"2035",1,23,15,-8,-20.3537935238945,2.8174,-0.1206,5
"2036",1,15,2,-13,-17.9755231235771,7.8174,12.8794,-3
"2037",1,16,20,4,-8.20613668893038,-9.1826,-5.1206,-2
"2038",1,21,26,5,-11.0194039236858,-10.1826,-11.1206,3
"2039",1,22,13,-9,-20.0609217052486,3.8174,1.8794,4
"2040",1,13,14,1,-7.76204882606773,-6.1826,0.8794,-5
"2041",1,24,2,-22,-29.5863527189832,16.8174,12.8794,6
"2042",1,23,10,-13,-23.5179754705835,7.8174,4.8794,5
"2043",1,17,29,12,-4.26936683158066,-17.1826,-14.1206,-1
"2044",1,13,10,-3,-10.159727021984,-2.1826,4.8794,-5
"2045",1,18,27,9,-6.92790472314089,-14.1826,-12.1206,0
"2046",1,19,16,-3,-14.365656421678,-2.1826,-1.1206,1
"2047",1,24,29,5,-13.1703272524432,-10.1826,-14.1206,6
"2048",1,18,12,-6,-15.6214578580546,0.8174,2.8794,0
"2049",1,25,13,-12,-24.1765370541238,6.8174,1.8794,7
"2050",1,22,10,-12,-22.0840160692155,6.8174,4.8794,4
"2051",1,25,18,-7,-21.2392984942733,1.8174,-3.1206,7
"2052",1,21,5,-16,-23.9984492334848,10.8174,9.8794,3
"2053",1,25,12,-13,-24.7250891241106,7.8174,2.8794,7
"2054",1,25,18,-7,-21.2069806014336,1.8174,-3.1206,7
"2055",1,23,26,3,-13.8775031109504,-8.1826,-11.1206,5
"2056",1,18,4,-14,-20.4379779278309,8.8174,10.8794,0
"2057",1,24,0,-24,-30.4938467653838,18.8174,14.8794,6
"2058",1,21,21,0,-14.0400683630387,-5.1826,-6.1206,3
"2059",1,6,26,20,8.23316841390096,-25.1826,-11.1206,-12
"2060",1,18,5,-13,-19.923583015204,7.8174,9.8794,0
"2061",1,22,1,-21,-27.4905878618376,15.8174,13.8794,4
"2062",1,19,7,-12,-19.734823752492,6.8174,7.8794,1
"2063",1,20,7,-13,-21.1400856969199,7.8174,7.8794,2
"2064",1,10,30,20,5.57145677584962,-25.1826,-15.1206,-8
"2065",1,15,30,15,-0.930034861681451,-20.1826,-15.1206,-3
"2066",1,21,20,-1,-14.8242334722095,-4.1826,-5.1206,3
"2067",1,19,9,-10,-18.8843338451476,4.8174,5.8794,1
"2068",1,19,4,-15,-21.8588597225394,9.8174,10.8794,1
"2069",1,20,8,-12,-20.7087251805238,6.8174,6.8794,2
"2070",1,24,8,-16,-26.2941386078459,10.8174,6.8794,6
"2071",1,19,24,5,-9.57839864619273,-10.1826,-9.1206,1
"2072",1,26,30,4,-15.3560485165576,-9.1826,-15.1206,8
"2073",1,20,1,-19,-24.77872310824,13.8174,13.8794,2
"2074",1,18,22,4,-9.76606856337679,-9.1826,-7.1206,0
"2075",1,21,2,-19,-25.5847501064225,13.8174,12.8794,3
"2076",1,21,24,3,-12.155221229336,-8.1826,-9.1206,3
"2077",1,24,19,-5,-19.2534212796691,-0.1826,-4.1206,6
"2078",1,22,12,-10,-21.0228980646258,4.8174,2.8794,4
"2079",1,14,25,11,-2.46411473009578,-16.1826,-10.1206,-4
"2080",1,18,12,-6,-15.7168702036505,0.8174,2.8794,0
"2081",1,14,16,2,-8.19722382376484,-7.1826,-1.1206,-4
"2082",1,21,0,-21,-26.7002744868116,15.8174,14.8794,3
"2083",1,20,14,-6,-17.1969473182063,0.8174,0.8794,2
"2084",1,19,29,10,-6.71771126510005,-15.1826,-14.1206,1
"2085",1,19,27,8,-8.03216241652976,-13.1826,-12.1206,1
"2086",1,18,26,8,-7.2859485456013,-13.1826,-11.1206,0
"2087",1,23,16,-7,-19.7488359828368,1.8174,-1.1206,5
"2088",1,17,5,-12,-18.7268906398193,6.8174,9.8794,-1
"2089",1,15,6,-9,-15.1041256353125,3.8174,8.8794,-3
"2090",1,26,14,-12,-24.7768034378849,6.8174,0.8794,8
"2091",1,22,1,-21,-27.5312199219683,15.8174,13.8794,4
"2092",1,15,14,-1,-10.4758928194058,-4.1826,0.8794,-3
"2093",1,18,11,-7,-16.3703399908153,1.8174,3.8794,0
"2094",1,23,7,-16,-25.1930345276727,10.8174,7.8794,5
"2095",1,12,5,-7,-12.1304688539447,1.8174,9.8794,-6
"2096",1,18,28,10,-6.04077966263333,-15.1826,-13.1206,0
"2097",1,15,18,3,-8.119509218849,-8.1826,-3.1206,-3
"2098",1,15,1,-14,-18.3881697309932,8.8174,13.8794,-3
"2099",1,19,30,11,-6.44961747180588,-16.1826,-15.1206,1
"2100",1,17,6,-11,-18.1793456043503,5.8174,8.8794,-1
"2101",1,16,6,-10,-17.1284410245738,4.8174,8.8794,-2
"2102",1,20,4,-16,-23.294426390784,10.8174,10.8794,2
"2103",1,21,18,-3,-15.9420073685116,-2.1826,-3.1206,3
"2104",1,17,7,-10,-17.2732552822667,4.8174,7.8794,-1
"2105",1,17,15,-2,-12.8207148774022,-3.1826,-0.1206,-1
"2106",1,12,4,-8,-12.8168876990683,2.8174,10.8794,-6
"2107",1,17,2,-15,-20.5205961952054,9.8174,12.8794,-1
"2108",1,20,18,-2,-14.5240591360999,-3.1826,-3.1206,2
"2109",1,25,9,-16,-26.6182544181611,10.8174,5.8794,7
"2110",1,26,21,-5,-20.6612081060301,-0.1826,-6.1206,8
"2111",1,13,30,17,1.62927258906352,-22.1826,-15.1206,-5
"2112",1,28,20,-8,-24.0250100058974,2.8174,-5.1206,10
"2113",1,14,18,4,-6.97845791243645,-9.1826,-3.1206,-4
"2114",1,28,2,-26,-34.6756846875241,20.8174,12.8794,10
"2115",1,13,5,-8,-13.3739981455335,2.8174,9.8794,-5
"2116",1,23,29,6,-12.0628979700177,-11.1826,-14.1206,5
"2117",1,22,11,-11,-21.5989097206051,5.8174,3.8794,4
"2118",1,14,4,-10,-15.1241200834956,4.8174,10.8794,-4
"2119",1,23,28,5,-12.5457692590224,-10.1826,-13.1206,5
"2120",1,20,20,0,-13.3270613350946,-5.1826,-5.1206,2
"2121",1,24,23,-1,-16.8894637488149,-4.1826,-8.1206,6
"2122",1,20,30,10,-7.26406271634279,-15.1826,-15.1206,2
"2123",1,20,17,-3,-15.4525371164137,-2.1826,-2.1206,2
"2124",1,25,5,-20,-28.8911686763431,14.8174,9.8794,7
"2125",1,22,27,5,-12.291097975614,-10.1826,-12.1206,4
"2126",1,11,22,11,-0.385579415456194,-16.1826,-7.1206,-7
"2127",1,19,18,-1,-13.3920530469108,-4.1826,-3.1206,1
"2128",1,22,17,-5,-17.7702530607521,-0.1826,-2.1206,4
"2129",1,22,20,-2,-16.0776121626396,-3.1826,-5.1206,4
"2130",1,24,23,-1,-17.0562881197104,-4.1826,-8.1206,6
"2131",1,18,2,-16,-21.3331548313275,10.8174,12.8794,0
"2132",1,24,7,-17,-26.6347239810384,11.8174,7.8794,6
"2133",1,20,25,5,-10.4638339380836,-10.1826,-10.1206,2
"2134",1,21,18,-3,-16.2407971649035,-2.1826,-3.1206,3
"2135",1,24,29,5,-13.140461925718,-10.1826,-14.1206,6
"2136",1,29,18,-11,-26.3094409491628,5.8174,-3.1206,11
"2137",1,16,22,6,-7.27813159794274,-11.1826,-7.1206,-2
"2138",1,21,25,4,-11.687569799301,-9.1826,-10.1206,3
"2139",1,24,16,-8,-21.1843045826015,2.8174,-1.1206,6
"2140",1,20,28,8,-8.91078857515404,-13.1826,-13.1206,2
"2141",1,23,15,-8,-20.5941836664999,2.8174,-0.1206,5
"2142",1,26,16,-10,-24.0048413924865,4.8174,-1.1206,8
"2143",1,23,1,-22,-28.5150407670702,16.8174,13.8794,5
"2144",1,23,15,-8,-20.3785802795494,2.8174,-0.1206,5
"2145",1,17,7,-10,-17.2723493683314,4.8174,7.8794,-1
"2146",1,14,6,-8,-14.0480114405761,2.8174,8.8794,-4
"2147",1,25,20,-5,-20.1714557197421,-0.1826,-5.1206,7
"2148",1,22,16,-6,-18.4008657008961,0.8174,-1.1206,4
"2149",1,29,14,-15,-28.8944491137001,9.8174,0.8794,11
"2150",1,20,22,2,-12.1507715861012,-7.1826,-7.1206,2
"2151",1,12,11,-1,-8.62974742170591,-4.1826,3.8794,-6
"2152",1,23,9,-14,-24.0457534610754,8.8174,5.8794,5
"2153",1,19,17,-2,-13.8222966121553,-3.1826,-2.1206,1
"2154",1,14,1,-13,-17.3430888831075,7.8174,13.8794,-4
"2155",1,21,7,-14,-22.4047770187388,8.8174,7.8794,3
"2156",1,27,0,-27,-34.5869805746547,21.8174,14.8794,9
"2157",1,20,14,-6,-17.1640533364708,0.8174,0.8794,2
"2158",1,17,2,-15,-20.2192115051941,9.8174,12.8794,-1
"2159",1,29,28,-1,-20.4060001553498,-4.1826,-13.1206,11
"2160",1,23,18,-5,-18.8009482134446,-0.1826,-3.1206,5
"2161",1,18,23,5,-9.01887875174071,-10.1826,-8.1206,0
"2162",1,16,7,-9,-16.2834072000447,3.8174,7.8794,-2
"2163",1,22,28,6,-11.3130446042054,-11.1826,-13.1206,4
"2164",1,23,17,-6,-19.4392584097294,0.8174,-2.1206,5
"2165",1,18,30,12,-4.83021433163816,-17.1826,-15.1206,0
"2166",1,25,15,-10,-23.0575085564013,4.8174,-0.1206,7
"2167",1,14,17,3,-7.35776703482847,-8.1826,-2.1206,-4
"2168",1,21,28,7,-9.91839549939857,-12.1826,-13.1206,3
"2169",1,24,22,-2,-17.1115628916224,-3.1826,-7.1206,6
"2170",1,21,0,-21,-26.6800712350022,15.8174,14.8794,3
"2171",1,20,21,1,-12.8438319209735,-6.1826,-6.1206,2
"2172",1,22,13,-9,-20.2366847823303,3.8174,1.8794,4
"2173",1,22,23,1,-14.1428502944314,-6.1826,-8.1206,4
"2174",1,17,18,1,-10.7406272157535,-6.1826,-3.1206,-1
"2175",1,22,22,0,-14.8536161761221,-5.1826,-7.1206,4
"2176",1,20,2,-18,-24.5214972270565,12.8174,12.8794,2
"2177",1,16,9,-7,-14.9810085104851,1.8174,5.8794,-2
"2178",1,18,12,-6,-15.6633217245599,0.8174,2.8794,0
"2179",1,22,2,-20,-26.935265517714,14.8174,12.8794,4
"2180",1,23,9,-14,-24.0663883227185,8.8174,5.8794,5
"2181",1,22,3,-19,-26.2442758503824,13.8174,11.8794,4
"2182",1,21,7,-14,-22.1811407636366,8.8174,7.8794,3
"2183",1,19,23,4,-10.3854742888629,-9.1826,-8.1206,1
"2184",1,23,2,-21,-28.1576779634108,15.8174,12.8794,5
"2185",1,17,21,4,-9.11250608216251,-9.1826,-6.1206,-1
"2186",1,16,20,4,-8.46783599956467,-9.1826,-5.1206,-2
"2187",1,18,13,-5,-14.9918796823625,-0.1826,1.8794,0
"2188",1,21,26,5,-11.0598004974223,-10.1826,-11.1206,3
"2189",1,22,18,-4,-17.4078263465003,-1.1826,-3.1206,4
"2190",1,18,6,-12,-19.5694359965257,6.8174,8.8794,0
"2191",1,19,26,7,-8.85608735599455,-12.1826,-11.1206,1
"2192",1,22,22,0,-14.882519915383,-5.1826,-7.1206,4
"2193",1,22,9,-13,-22.815179667967,7.8174,5.8794,4
"2194",1,19,24,5,-9.92875400834199,-10.1826,-9.1206,1
"2195",1,18,17,-1,-12.4845469154203,-4.1826,-2.1206,0
"2196",1,16,29,13,-2.79176444968045,-18.1826,-14.1206,-2
"2197",1,11,22,11,-0.344578855193902,-16.1826,-7.1206,-7
"2198",1,20,29,9,-7.95017780279484,-14.1826,-14.1206,2
"2199",1,15,6,-9,-15.3831697732287,3.8174,8.8794,-3
"2200",1,20,10,-10,-19.9170231658911,4.8174,4.8794,2
"2201",1,20,5,-15,-22.4228251143192,9.8174,9.8794,2
"2202",1,16,23,7,-6.56955306544311,-12.1826,-8.1206,-2
"2203",1,21,15,-6,-17.6934597568077,0.8174,-0.1206,3
"2204",1,18,8,-10,-17.9844225416242,4.8174,6.8794,0
"2205",1,26,29,3,-15.9574150549223,-8.1826,-14.1206,8
"2206",1,22,13,-9,-20.1577179013562,3.8174,1.8794,4
"2207",1,19,17,-2,-14.086644384179,-3.1826,-2.1206,1
"2208",1,18,27,9,-6.77326456985756,-14.1826,-12.1206,0
"2209",1,17,6,-11,-17.6687552143891,5.8174,8.8794,-1
"2210",1,17,0,-17,-21.3467305394164,11.8174,14.8794,-1
"2211",1,20,13,-7,-17.8624822664736,1.8174,1.8794,2
"2212",1,16,4,-12,-17.7810513099439,6.8174,10.8794,-2
"2213",1,22,4,-18,-25.6959801432059,12.8174,10.8794,4
"2214",1,14,29,15,-0.509858024923735,-20.1826,-14.1206,-4
"2215",1,19,1,-18,-23.7069265894977,12.8174,13.8794,1
"2216",1,21,18,-3,-15.8584933366408,-2.1826,-3.1206,3
"2217",1,25,5,-20,-28.8633895296065,14.8174,9.8794,7
"2218",1,23,25,2,-14.5268000134965,-7.1826,-10.1206,5
"2219",1,23,10,-13,-22.9639478505966,7.8174,4.8794,5
"2220",1,16,2,-14,-19.0080479994287,8.8174,12.8794,-2
"2221",1,14,1,-13,-17.1482961446787,7.8174,13.8794,-4
"2222",1,12,22,10,-2.16381547042612,-15.1826,-7.1206,-6
"2223",1,21,2,-19,-25.7400083899838,13.8174,12.8794,3
"2224",1,15,5,-10,-15.7788486938652,4.8174,9.8794,-3
"2225",1,15,19,4,-7.47212730956851,-9.1826,-4.1206,-3
"2226",1,19,15,-4,-14.9234273021369,-1.1826,-0.1206,1
"2227",1,17,15,-2,-12.6950787027499,-3.1826,-0.1206,-1
"2228",1,24,4,-20,-28.3987372801536,14.8174,10.8794,6
"2229",1,21,18,-3,-16.0859956820839,-2.1826,-3.1206,3
"2230",1,29,3,-26,-35.6864335562405,20.8174,11.8794,11
"2231",1,14,20,6,-5.73347506987818,-11.1826,-5.1206,-4
"2232",1,14,3,-11,-15.9731289990023,5.8174,11.8794,-4
"2233",1,23,25,2,-14.5228359889725,-7.1826,-10.1206,5
"2234",1,17,8,-9,-16.8185263171337,3.8174,6.8794,-1
"2235",1,18,11,-7,-16.3112253928076,1.8174,3.8794,0
"2236",1,10,11,1,-5.57848490713867,-6.1826,3.8794,-8
"2237",1,19,5,-14,-21.2254981794706,8.8174,9.8794,1
"2238",1,18,29,11,-5.60528716235527,-16.1826,-14.1206,0
"2239",1,21,0,-21,-26.9474888703403,15.8174,14.8794,3
"2240",1,19,9,-10,-19.1143168379504,4.8174,5.8794,1
"2241",1,23,22,-1,-16.2921433488269,-4.1826,-7.1206,5
"2242",1,23,1,-22,-28.7017545603258,16.8174,13.8794,5
"2243",1,24,20,-4,-18.7276290934501,-1.1826,-5.1206,6
"2244",1,25,11,-14,-25.8018048199106,8.8174,3.8794,7
"2245",1,14,12,-2,-10.5154999129447,-3.1826,2.8794,-4
"2246",1,13,5,-8,-13.4441188792209,2.8174,9.8794,-5
"2247",1,29,9,-20,-32.1446287082582,14.8174,5.8794,11
"2248",1,24,5,-19,-27.6752005350299,13.8174,9.8794,6
"2249",1,17,23,6,-7.58539098195,-11.1826,-8.1206,-1
"2250",1,15,22,7,-5.84007839051851,-12.1826,-7.1206,-3
"2251",1,20,17,-3,-15.3551955848815,-2.1826,-2.1206,2
"2252",1,21,30,9,-8.87625690008259,-14.1826,-15.1206,3
"2253",1,17,24,7,-6.99432367611456,-12.1826,-9.1206,-1
"2254",1,19,4,-15,-21.6156428398025,9.8174,10.8794,1
"2255",1,22,22,0,-14.8224139155027,-5.1826,-7.1206,4
"2256",1,22,26,4,-12.5376359031851,-9.1826,-11.1206,4
"2257",1,16,17,1,-10.2035289993708,-6.1826,-2.1206,-2
"2258",1,29,4,-25,-34.4129992243686,19.8174,10.8794,11
"2259",1,17,25,8,-6.71319197112277,-13.1826,-10.1206,-1
"2260",1,16,19,3,-8.90717833092505,-8.1826,-4.1206,-2
"2261",1,19,28,9,-7.51717422330671,-14.1826,-13.1206,1
"2262",1,25,4,-21,-29.7922770346684,15.8174,10.8794,7
"2263",1,18,15,-3,-13.6741778025274,-2.1826,-0.1206,0
"2264",1,17,0,-17,-21.4897297073487,11.8174,14.8794,-1
"2265",1,26,6,-20,-29.8189631611418,14.8174,8.8794,8
"2266",1,28,25,-3,-20.7522504798458,-2.1826,-10.1206,10
"2267",1,14,0,-14,-17.8307761606248,8.8174,14.8794,-4
"2268",1,24,6,-18,-27.1809530550354,12.8174,8.8794,6
"2269",1,20,24,4,-11.0102831830005,-9.1826,-9.1206,2
"2270",1,22,30,8,-10.0741583107468,-13.1826,-15.1206,4
"2271",1,13,17,4,-5.92610674953653,-9.1826,-2.1206,-5
"2272",1,19,1,-18,-23.6593674999353,12.8174,13.8794,1
"2273",1,24,15,-9,-21.6173187475403,3.8174,-0.1206,6
"2274",1,17,17,0,-11.6212517474129,-5.1826,-2.1206,-1
"2275",1,19,13,-6,-16.5114774085242,0.8174,1.8794,1
"2276",1,16,21,5,-7.64657188038188,-10.1826,-6.1206,-2
"2277",1,9,30,21,6.89726247817039,-26.1826,-15.1206,-9
"2278",1,19,13,-6,-16.5057134360289,0.8174,1.8794,1
"2279",1,18,19,1,-11.489697914496,-6.1826,-4.1206,0
"2280",1,23,17,-6,-19.2559237423455,0.8174,-2.1206,5
"2281",1,25,7,-18,-27.6648999784959,12.8174,7.8794,7
"2282",1,17,28,11,-4.76749137525837,-16.1826,-13.1206,-1
"2283",1,18,2,-16,-21.541009490589,10.8174,12.8794,0
"2284",1,25,25,0,-16.9397024566654,-5.1826,-10.1206,7
"2285",1,25,17,-8,-21.6729820072773,2.8174,-2.1206,7
"2286",1,19,4,-15,-21.7346509904332,9.8174,10.8794,1
"2287",1,17,10,-7,-15.9088173078283,1.8174,4.8794,-1
"2288",1,21,29,8,-9.53086127086885,-13.1826,-14.1206,3
"2289",1,18,6,-12,-19.3236009731424,6.8174,8.8794,0
"2290",1,19,3,-16,-22.6766966229405,10.8174,11.8794,1
"2291",1,23,5,-18,-26.2347044650138,12.8174,9.8794,5
"2292",1,16,28,12,-3.378706380954,-17.1826,-13.1206,-2
"2293",1,13,9,-4,-10.9487959048351,-1.1826,5.8794,-5
"2294",1,22,16,-6,-18.7032894483354,0.8174,-1.1206,4
"2295",1,20,30,10,-7.58092943252587,-15.1826,-15.1206,2
"2296",1,31,4,-27,-37.3712142762554,21.8174,10.8794,13
"2297",1,20,12,-8,-18.4172854413166,2.8174,2.8794,2
"2298",1,26,2,-24,-32.0997925733694,18.8174,12.8794,8
"2299",1,21,30,9,-8.65814644444546,-14.1826,-15.1206,3
"2300",1,28,23,-5,-21.8632469604654,-0.1826,-8.1206,10
"2301",1,18,28,10,-6.11958823192739,-15.1826,-13.1206,0
"2302",1,17,30,13,-3.44683006784886,-18.1826,-15.1206,-1
"2303",1,24,28,4,-13.9926671708406,-9.1826,-13.1206,6
"2304",1,25,14,-11,-23.7847772559422,5.8174,0.8794,7
"2305",1,17,28,11,-4.80137755295035,-16.1826,-13.1206,-1
"2306",1,24,17,-7,-20.6154134245091,1.8174,-2.1206,6
"2307",1,30,22,-8,-25.4203054973961,2.8174,-7.1206,12
"2308",1,16,12,-4,-13.1226860912055,-1.1826,2.8794,-2
"2309",1,15,23,8,-5.42779842999789,-13.1826,-8.1206,-3
"2310",1,24,25,1,-15.7948048297632,-6.1826,-10.1206,6
"2311",1,23,24,1,-14.8068596376578,-6.1826,-9.1206,5
"2312",1,23,12,-11,-22.3464961887606,5.8174,2.8794,5
"2313",1,12,12,0,-8.07915642422079,-5.1826,2.8794,-6
"2314",1,17,11,-6,-15.2308128484025,0.8174,3.8794,-1
"2315",1,19,30,11,-6.21423021540313,-16.1826,-15.1206,1
"2316",1,17,24,7,-7.13344016721081,-12.1826,-9.1206,-1
"2317",1,27,15,-12,-25.6003074588887,6.8174,-0.1206,9
"2318",1,23,2,-21,-27.9465011135292,15.8174,12.8794,5
"2319",1,21,25,4,-11.6068773781479,-9.1826,-10.1206,3
"2320",1,11,22,11,-0.60857797760272,-16.1826,-7.1206,-7
"2321",1,28,26,-2,-20.0931135565679,-3.1826,-11.1206,10
"2322",1,23,15,-8,-20.4550747203944,2.8174,-0.1206,5
"2323",1,13,1,-12,-15.7577712207555,6.8174,13.8794,-5
"2324",1,23,16,-7,-19.7562039977969,1.8174,-1.1206,5
"2325",1,19,9,-10,-18.8779185580252,4.8174,5.8794,1
"2326",1,21,3,-18,-25.0764352391714,12.8174,11.8794,3
"2327",1,22,10,-12,-22.0084279318568,6.8174,4.8794,4
"2328",1,17,18,1,-11.150541471763,-6.1826,-3.1206,-1
"2329",1,16,23,7,-6.62492140569699,-12.1826,-8.1206,-2
"2330",1,23,1,-22,-29.004740861003,16.8174,13.8794,5
"2331",1,17,19,2,-10.1226242619084,-7.1826,-4.1206,-1
"2332",1,24,20,-4,-18.3415572571436,-1.1826,-5.1206,6
"2333",1,23,27,4,-13.5243207106693,-9.1826,-12.1206,5
"2334",1,27,18,-9,-23.8957778481967,3.8174,-3.1206,9
"2335",1,18,9,-9,-17.3869688624384,3.8174,5.8794,0
"2336",1,24,16,-8,-21.1900586708032,2.8174,-1.1206,6
"2337",1,29,9,-20,-31.7940973062545,14.8174,5.8794,11
"2338",1,16,11,-5,-13.5952383782877,-0.1826,3.8794,-2
"2339",1,20,24,4,-11.029093428279,-9.1826,-9.1206,2
"2340",1,20,10,-10,-19.6638363377401,4.8174,4.8794,2
"2341",1,19,22,3,-11.0250342341523,-8.1826,-7.1206,1
"2342",1,19,28,9,-7.28832635608069,-14.1826,-13.1206,1
"2343",1,16,22,6,-7.05686010811412,-11.1826,-7.1206,-2
"2344",1,22,4,-18,-25.7450518723954,12.8174,10.8794,4
"2345",1,22,10,-12,-22.1985970367299,6.8174,4.8794,4
"2346",1,21,0,-21,-26.6368004160867,15.8174,14.8794,3
"2347",1,27,30,3,-16.6924979926657,-8.1826,-15.1206,9
"2348",1,26,16,-10,-23.74215454284,4.8174,-1.1206,8
"2349",1,11,24,13,0.521281450922315,-18.1826,-9.1206,-7
"2350",1,17,14,-3,-13.3024854941981,-2.1826,0.8794,-1
"2351",1,17,0,-17,-21.4630882295373,11.8174,14.8794,-1
"2352",1,18,28,10,-6.12107887969277,-15.1826,-13.1206,0
"2353",1,15,15,0,-9.73633080178424,-5.1826,-0.1206,-3
"2354",1,20,5,-15,-22.5495070218221,9.8174,9.8794,2
"2355",1,18,8,-10,-17.9939323425911,4.8174,6.8794,0
"2356",1,15,22,7,-6.0957200212071,-12.1826,-7.1206,-3
"2357",1,25,20,-5,-20.1233657822179,-0.1826,-5.1206,7
"2358",1,20,29,9,-8.10321649231509,-14.1826,-14.1206,2
"2359",1,14,12,-2,-10.4595790723207,-3.1826,2.8794,-4
"2360",1,16,10,-6,-14.1949712543259,0.8174,4.8794,-2
"2361",1,20,18,-2,-14.8337889834835,-3.1826,-3.1206,2
"2362",1,21,22,1,-13.5560889907563,-6.1826,-7.1206,3
"2363",1,16,26,10,-4.73897954805744,-15.1826,-11.1206,-2
"2364",1,16,3,-13,-18.6220520101543,7.8174,11.8794,-2
"2365",1,25,19,-6,-20.5929850592715,0.8174,-4.1206,7
"2366",1,16,30,14,-2.10086370090592,-19.1826,-15.1206,-2
"2367",1,12,17,5,-4.9129415390542,-10.1826,-2.1206,-6
"2368",1,17,30,13,-3.391531665515,-18.1826,-15.1206,-1
"2369",1,21,13,-8,-18.9178399501591,2.8174,1.8794,3
"2370",1,21,27,6,-10.9107750301255,-11.1826,-12.1206,3
"2371",1,16,0,-16,-20.3064846799403,10.8174,14.8794,-2
"2372",1,15,12,-3,-11.6425074661487,-2.1826,2.8794,-3
"2373",1,27,5,-22,-31.7199623637449,16.8174,9.8794,9
"2374",1,29,8,-21,-32.475005743117,15.8174,6.8794,11
"2375",1,14,3,-11,-15.7098938401255,5.8174,11.8794,-4
"2376",1,18,13,-5,-15.0086502303359,-0.1826,1.8794,0
"2377",1,18,27,9,-6.63519073612964,-14.1826,-12.1206,0
"2378",1,16,13,-3,-12.5169301370183,-2.1826,1.8794,-2
"2379",1,21,18,-3,-15.8358497425916,-2.1826,-3.1206,3
"2380",1,15,9,-6,-13.733038974729,0.8174,5.8794,-3
"2381",1,23,2,-21,-28.0971699871889,15.8174,12.8794,5
"2382",1,25,9,-16,-26.4725765601089,10.8174,5.8794,7
"2383",1,22,21,-1,-15.8082270798465,-4.1826,-6.1206,4
"2384",1,18,1,-17,-22.6029467379297,11.8174,13.8794,0
"2385",1,17,21,4,-9.15512749343114,-9.1826,-6.1206,-1
"2386",1,25,25,0,-16.8566623456367,-5.1826,-10.1206,7
"2387",1,18,19,1,-11.389364653861,-6.1826,-4.1206,0
"2388",1,15,30,15,-1.02302449872696,-20.1826,-15.1206,-3
"2389",1,12,18,6,-4.35168669082577,-11.1826,-3.1206,-6
"2390",1,24,28,4,-13.7930403434239,-9.1826,-13.1206,6
"2391",1,17,5,-12,-18.5299347403505,6.8174,9.8794,-1
"2392",1,19,10,-9,-18.0908446586685,3.8174,4.8794,1
"2393",1,19,1,-18,-23.2078581044896,12.8174,13.8794,1
"2394",1,20,25,5,-10.7397018144834,-10.1826,-10.1206,2
"2395",1,20,26,6,-10.0974689990687,-11.1826,-11.1206,2
"2396",1,22,7,-15,-23.597098756068,9.8174,7.8794,4
"2397",1,17,16,-1,-11.980301777381,-4.1826,-1.1206,-1
"2398",1,18,3,-15,-21.0904510666598,9.8174,11.8794,0
"2399",1,16,20,4,-8.14581602825326,-9.1826,-5.1206,-2
"2400",1,21,28,7,-9.83353263020273,-12.1826,-13.1206,3
"2401",1,20,22,2,-12.3921281396357,-7.1826,-7.1206,2
"2402",1,24,1,-23,-30.1463187233264,17.8174,13.8794,6
"2403",1,24,27,3,-14.4689704493117,-8.1826,-12.1206,6
"2404",1,18,5,-13,-19.9093312685813,7.8174,9.8794,0
"2405",1,36,9,-27,-40.919501398396,21.8174,5.8794,18
"2406",1,19,28,9,-7.68738837993579,-14.1826,-13.1206,1
"2407",1,13,30,17,1.66001689697482,-22.1826,-15.1206,-5
"2408",1,18,12,-6,-15.5702260319382,0.8174,2.8794,0
"2409",1,19,23,4,-10.4776178664688,-9.1826,-8.1206,1
"2410",1,13,10,-3,-10.5849138234301,-2.1826,4.8794,-5
"2411",1,11,20,9,-1.72463182932776,-14.1826,-5.1206,-7
"2412",1,15,12,-3,-11.813145572097,-2.1826,2.8794,-3
"2413",1,16,30,14,-2.42565690308884,-19.1826,-15.1206,-2
"2414",1,19,22,3,-11.1610751016816,-8.1826,-7.1206,1
"2415",1,17,7,-10,-17.2093985544304,4.8174,7.8794,-1
"2416",1,19,15,-4,-15.315378317727,-1.1826,-0.1206,1
"2417",1,21,5,-16,-23.9530818123665,10.8174,9.8794,3
"2418",1,17,1,-16,-20.9176045379823,10.8174,13.8794,-1
"2419",1,20,26,6,-10.1237013132374,-11.1826,-11.1206,2
"2420",1,33,28,-5,-25.543209130391,-0.1826,-13.1206,15
"2421",1,16,10,-6,-14.4021995853129,0.8174,4.8794,-2
"2422",1,17,10,-7,-15.6867444402366,1.8174,4.8794,-1
"2423",1,33,24,-9,-28.259381985619,3.8174,-9.1206,15
"2424",1,20,17,-3,-15.4090569613817,-2.1826,-2.1206,2
"2425",1,23,0,-23,-29.6565000516396,17.8174,14.8794,5
"2426",1,16,20,4,-8.39457835804246,-9.1826,-5.1206,-2
"2427",1,20,19,-1,-13.7417527449199,-4.1826,-4.1206,2
"2428",1,14,6,-8,-13.9354167820698,2.8174,8.8794,-4
"2429",1,32,23,-9,-27.224811919085,3.8174,-8.1206,14
"2430",1,16,18,2,-9.7682205867266,-7.1826,-3.1206,-2
"2431",1,25,2,-23,-30.9673798589055,17.8174,12.8794,7
"2432",1,17,0,-17,-21.7240350478692,11.8174,14.8794,-1
"2433",1,24,27,3,-14.3036908912194,-8.1826,-12.1206,6
"2434",1,21,14,-7,-18.4267118936155,1.8174,0.8794,3
"2435",1,20,23,3,-11.771830354253,-8.1826,-8.1206,2
"2436",1,19,30,11,-6.11627026857612,-16.1826,-15.1206,1
"2437",1,19,15,-4,-14.9589707624861,-1.1826,-0.1206,1
"2438",1,17,8,-9,-16.6814729504205,3.8174,6.8794,-1
"2439",1,20,9,-11,-20.1026161049971,5.8174,5.8794,2
"2440",1,20,19,-1,-13.9744386945392,-4.1826,-4.1206,2
"2441",1,19,28,9,-7.4730732029235,-14.1826,-13.1206,1
"2442",1,24,14,-10,-22.2947596965794,4.8174,0.8794,6
"2443",1,20,28,8,-8.67445435627985,-13.1826,-13.1206,2
"2444",1,23,10,-13,-23.2868783949731,7.8174,4.8794,5
"2445",1,20,2,-18,-24.2808045185663,12.8174,12.8794,2
"2446",1,27,16,-11,-25.0810482792929,5.8174,-1.1206,9
"2447",1,12,14,2,-6.67493316906462,-7.1826,0.8794,-6
"2448",1,17,8,-9,-16.8246061294765,3.8174,6.8794,-1
"2449",1,13,9,-4,-11.1032404363858,-1.1826,5.8794,-5
"2450",1,27,18,-9,-23.4593657892907,3.8174,-3.1206,9
"2451",1,24,25,1,-15.5733199247481,-6.1826,-10.1206,6
"2452",1,22,11,-11,-21.3886814305035,5.8174,3.8794,4
"2453",1,21,19,-2,-15.3774299158392,-3.1826,-4.1206,3
"2454",1,19,16,-3,-14.5916511269993,-2.1826,-1.1206,1
"2455",1,20,9,-11,-20.105458110177,5.8174,5.8794,2
"2456",1,21,12,-9,-19.7660509353447,3.8174,2.8794,3
"2457",1,19,13,-6,-16.3668525757179,0.8174,1.8794,1
"2458",1,23,25,2,-14.40236378961,-7.1826,-10.1206,5
"2459",1,18,25,7,-7.95177464866694,-12.1826,-10.1206,0
"2460",1,21,26,5,-11.5677001489266,-10.1826,-11.1206,3
"2461",1,20,4,-16,-22.9849377023818,10.8174,10.8794,2
"2462",1,29,24,-5,-22.7415061568987,-0.1826,-9.1206,11
"2463",1,21,1,-20,-26.3535072346316,14.8174,13.8794,3
"2464",1,24,26,2,-15.1517334168418,-7.1826,-11.1206,6
"2465",1,13,20,7,-4.45338649843219,-12.1826,-5.1206,-5
"2466",1,21,27,6,-10.3581390735987,-11.1826,-12.1206,3
"2467",1,26,18,-8,-22.4172350901761,2.8174,-3.1206,8
"2468",1,24,9,-15,-25.2689520740814,9.8174,5.8794,6
"2469",1,21,5,-16,-23.8100414507088,10.8174,9.8794,3
"2470",1,19,29,10,-6.80681077984273,-15.1826,-14.1206,1
"2471",1,29,16,-13,-27.8178403485152,7.8174,-1.1206,11
"2472",1,22,26,4,-12.4062879222797,-9.1826,-11.1206,4
"2473",1,25,2,-23,-30.8712570202302,17.8174,12.8794,7
"2474",1,21,14,-7,-18.4851084192899,1.8174,0.8794,3
"2475",1,25,9,-16,-26.6968757943418,10.8174,5.8794,7
"2476",1,17,17,0,-11.1602680667733,-5.1826,-2.1206,-1
"2477",1,18,17,-1,-12.6708267631943,-4.1826,-2.1206,0
"2478",1,19,26,7,-8.88648283363325,-12.1826,-11.1206,1
"2479",1,19,12,-7,-16.7598003686017,1.8174,2.8794,1
"2480",1,17,21,4,-8.67141235604689,-9.1826,-6.1206,-1
"2481",1,14,22,8,-4.54881869526596,-13.1826,-7.1206,-4
"2482",1,20,8,-12,-20.7397254933573,6.8174,6.8794,2
"2483",1,22,26,4,-12.6434044172875,-9.1826,-11.1206,4
"2484",1,20,30,10,-7.44675688546118,-15.1826,-15.1206,2
"2485",1,17,19,2,-10.0639885735373,-7.1826,-4.1206,-1
"2486",1,22,10,-12,-22.181321133209,6.8174,4.8794,4
"2487",1,16,25,9,-5.18585389912707,-14.1826,-10.1206,-2
"2488",1,28,19,-9,-24.4799786612231,3.8174,-4.1206,10
"2489",1,22,12,-10,-20.9819802090539,4.8174,2.8794,4
"2490",1,20,6,-14,-21.9674270747459,8.8174,8.8794,2
"2491",1,28,6,-22,-32.4392136887507,16.8174,8.8794,10
"2492",1,18,12,-6,-15.6741156018648,0.8174,2.8794,0
"2493",1,16,12,-4,-13.2939072320081,-1.1826,2.8794,-2
"2494",1,15,22,7,-5.78670315469771,-12.1826,-7.1206,-3
"2495",1,23,22,-1,-16.1901483671738,-4.1826,-7.1206,5
"2496",1,18,3,-15,-21.1038769390437,9.8174,11.8794,0
"2497",1,22,8,-14,-23.423120587417,8.8174,6.8794,4
"2498",1,7,14,7,-0.319052302067432,-12.1826,0.8794,-11
"2499",1,20,22,2,-12.1543828003148,-7.1826,-7.1206,2
"2500",1,29,10,-19,-31.3035062069238,13.8174,4.8794,11
"2501",1,13,7,-6,-12.1098885425219,0.8174,7.8794,-5
"2502",1,19,20,1,-12.0798251853222,-6.1826,-5.1206,1
"2503",1,18,30,12,-5.2226741841162,-17.1826,-15.1206,0
"2504",1,18,6,-12,-18.9234815155894,6.8174,8.8794,0
"2505",1,26,6,-20,-29.8049117524105,14.8174,8.8794,8
"2506",1,16,20,4,-8.27062142226433,-9.1826,-5.1206,-2
"2507",1,13,5,-8,-13.4051700830543,2.8174,9.8794,-5
"2508",1,16,3,-13,-18.4835935443893,7.8174,11.8794,-2
"2509",1,10,1,-9,-11.595539070483,3.8174,13.8794,-8
"2510",1,22,26,4,-12.5253704969281,-9.1826,-11.1206,4
"2511",1,13,7,-6,-12.3253498146006,0.8174,7.8794,-5
"2512",1,23,27,4,-13.1365663624788,-9.1826,-12.1206,5
"2513",1,17,5,-12,-18.5645287245729,6.8174,9.8794,-1
"2514",1,18,20,2,-10.9959734904365,-7.1826,-5.1206,0
"2515",1,21,9,-12,-21.2973954571893,6.8174,5.8794,3
"2516",1,20,25,5,-10.3164893433814,-10.1826,-10.1206,2
"2517",1,10,14,4,-4.40492896013991,-9.1826,0.8794,-8
"2518",1,16,25,9,-5.38057592384637,-14.1826,-10.1206,-2
"2519",1,17,19,2,-10.1953377410468,-7.1826,-4.1206,-1
"2520",1,27,22,-5,-21.5089082763224,-0.1826,-7.1206,9
"2521",1,23,8,-15,-24.5445809365632,9.8174,6.8794,5
"2522",1,28,7,-21,-31.5451899009014,15.8174,7.8794,10
"2523",1,17,28,11,-4.67342794878336,-16.1826,-13.1206,-1
"2524",1,23,30,7,-11.3956885228142,-12.1826,-15.1206,5
"2525",1,24,30,6,-12.8286000605174,-11.1826,-15.1206,6
"2526",1,20,17,-3,-15.43354124261,-2.1826,-2.1206,2
"2527",1,22,8,-14,-23.2806260481803,8.8174,6.8794,4
"2528",1,22,2,-20,-27.0243012550989,14.8174,12.8794,4
"2529",1,25,18,-7,-21.027657963547,1.8174,-3.1206,7
"2530",1,18,7,-11,-18.7539531925013,5.8174,7.8794,0
"2531",1,17,27,10,-5.6726656078024,-15.1826,-12.1206,-1
"2532",1,17,12,-5,-14.5054043179915,-0.1826,2.8794,-1
"2533",1,20,15,-5,-16.661572142515,-0.1826,-0.1206,2
"2534",1,21,27,6,-10.6943748648581,-11.1826,-12.1206,3
"2535",1,16,25,9,-5.38848355131386,-14.1826,-10.1206,-2
"2536",1,18,3,-15,-20.9581702012137,9.8174,11.8794,0
"2537",1,25,26,1,-16.4226698019235,-6.1826,-11.1206,7
"2538",1,23,21,-2,-16.6736113681569,-3.1826,-6.1206,5
"2539",1,22,11,-11,-21.3366615965829,5.8174,3.8794,4
"2540",1,22,20,-2,-16.2093539953657,-3.1826,-5.1206,4
"2541",1,18,28,10,-6.25512122517283,-15.1826,-13.1206,0
"2542",1,19,25,6,-9.15503292343625,-11.1826,-10.1206,1
"2543",1,26,18,-8,-22.4720979832842,2.8174,-3.1206,8
"2544",1,24,28,4,-13.4521875653862,-9.1826,-13.1206,6
"2545",1,21,5,-16,-23.7322206190395,10.8174,9.8794,3
"2546",1,23,22,-1,-16.2469422355597,-4.1826,-7.1206,5
"2547",1,25,29,4,-14.5352110928076,-9.1826,-14.1206,7
"2548",1,16,18,2,-9.48453172972642,-7.1826,-3.1206,-2
"2549",1,16,4,-12,-17.9999770574984,6.8174,10.8794,-2
"2550",1,28,5,-23,-32.8842299167963,17.8174,9.8794,10
"2551",1,27,1,-26,-34.0492918072021,20.8174,13.8794,9
"2552",1,15,16,1,-9.48313103851324,-6.1826,-1.1206,-3
"2553",1,22,7,-15,-23.8307981669482,9.8174,7.8794,4
"2554",1,26,11,-15,-26.4578659509823,9.8174,3.8794,8
"2555",1,32,27,-5,-25.1370933354569,-0.1826,-12.1206,14
"2556",1,12,14,2,-6.68459355214066,-7.1826,0.8794,-6
"2557",1,28,28,0,-18.9110591810967,-5.1826,-13.1206,10
"2558",1,16,20,4,-8.44367894462023,-9.1826,-5.1206,-2
"2559",1,10,14,4,-3.87101035360981,-9.1826,0.8794,-8
"2560",1,19,27,8,-7.97211580389115,-13.1826,-12.1206,1
"2561",1,18,12,-6,-15.6236252281725,0.8174,2.8794,0
"2562",1,18,22,4,-9.76114125707676,-9.1826,-7.1206,0
"2563",1,13,18,5,-5.68087778721589,-10.1826,-3.1206,-5
"2564",1,23,22,-1,-16.1963919785621,-4.1826,-7.1206,5
"2565",1,19,28,9,-7.49504192062828,-14.1826,-13.1206,1
"2566",1,25,8,-17,-27.2062526540821,11.8174,6.8794,7
"2567",1,11,0,-11,-13.72271007382,5.8174,14.8794,-7
"2568",1,21,3,-18,-24.9345530940658,12.8174,11.8794,3
"2569",1,16,17,1,-10.3528571377002,-6.1826,-2.1206,-2
"2570",1,25,22,-3,-18.4758603588634,-2.1826,-7.1206,7
"2571",1,29,26,-3,-21.5344460266918,-2.1826,-11.1206,11
"2572",1,19,16,-3,-14.5897900250557,-2.1826,-1.1206,1
"2573",1,23,6,-17,-25.8828841567024,11.8174,8.8794,5
"2574",1,21,1,-20,-26.1827667073173,14.8174,13.8794,3
"2575",1,24,14,-10,-22.325619454458,4.8174,0.8794,6
"2576",1,15,13,-2,-11.1311248709985,-3.1826,1.8794,-3
"2577",1,13,18,5,-5.7612220987833,-10.1826,-3.1206,-5
"2578",1,16,27,11,-4.09076907432338,-16.1826,-12.1206,-2
"2579",1,20,12,-8,-18.5304986712703,2.8174,2.8794,2
"2580",1,20,0,-20,-25.3109524653687,14.8174,14.8794,2
"2581",1,13,16,3,-6.76541453645126,-8.1826,-1.1206,-5
"2582",1,25,1,-24,-31.3112806082164,18.8174,13.8794,7
"2583",1,14,30,16,0.177909115930584,-21.1826,-15.1206,-4
"2584",1,25,11,-14,-25.473564820887,8.8174,3.8794,7
"2585",1,23,22,-1,-15.9959113346827,-4.1826,-7.1206,5
"2586",1,21,3,-18,-25.0071821727577,12.8174,11.8794,3
"2587",1,24,13,-11,-22.9432414743889,5.8174,1.8794,6
"2588",1,21,9,-12,-21.4133020736396,6.8174,5.8794,3
"2589",1,20,7,-13,-21.2152966816386,7.8174,7.8794,2
"2590",1,22,28,6,-11.3288910893448,-11.1826,-13.1206,4
"2591",1,18,1,-17,-22.3183783593819,11.8174,13.8794,0
"2592",1,17,12,-5,-14.0739402259725,-0.1826,2.8794,-1
"2593",1,22,11,-11,-21.6305494356833,5.8174,3.8794,4
"2594",1,27,3,-24,-32.7886738221014,18.8174,11.8794,9
"2595",1,25,10,-15,-26.0747454278207,9.8174,4.8794,7
"2596",1,12,8,-4,-10.1377109234563,-1.1826,6.8794,-6
"2597",1,21,15,-6,-17.9971371873707,0.8174,-0.1206,3
"2598",1,17,26,9,-5.92956337958728,-14.1826,-11.1206,-1
"2599",1,12,21,9,-2.2831760526732,-14.1826,-6.1206,-6
"2600",1,20,8,-12,-20.6451652309312,6.8174,6.8794,2
"2601",1,14,13,-1,-9.75507545553046,-4.1826,1.8794,-4
"2602",1,21,18,-3,-16.1027559161857,-2.1826,-3.1206,3
"2603",1,18,13,-5,-15.2458179572931,-0.1826,1.8794,0
"2604",1,19,24,5,-9.67285805849759,-10.1826,-9.1206,1
"2605",1,22,24,2,-13.5786682865392,-7.1826,-9.1206,4
"2606",1,22,9,-13,-22.8838106142436,7.8174,5.8794,4
"2607",1,20,14,-6,-16.770294574157,0.8174,0.8794,2
"2608",1,17,4,-13,-19.3941229224119,7.8174,10.8794,-1
"2609",1,14,11,-3,-11.3916114688417,-2.1826,3.8794,-4
"2610",1,18,24,6,-8.47004212944909,-11.1826,-9.1206,0
"2611",1,18,15,-3,-13.8877304109278,-2.1826,-0.1206,0
"2612",1,22,26,4,-12.6552191722592,-9.1826,-11.1206,4
"2613",1,17,14,-3,-13.2565798894169,-2.1826,0.8794,-1
"2614",1,24,11,-13,-23.9621552783352,7.8174,3.8794,6
"2615",1,17,11,-6,-14.8730707759711,0.8174,3.8794,-1
"2616",1,25,5,-20,-29.2056281616708,14.8174,9.8794,7
"2617",1,26,11,-15,-26.4834981490554,9.8174,3.8794,8
"2618",1,28,0,-28,-35.7993445380031,22.8174,14.8794,10
"2619",1,16,1,-15,-19.5834983730463,9.8174,13.8794,-2
"2620",1,22,10,-12,-22.2127558695929,6.8174,4.8794,4
"2621",1,19,9,-10,-18.9758419608648,4.8174,5.8794,1
"2622",1,23,18,-5,-18.5093703755534,-0.1826,-3.1206,5
"2623",1,24,2,-22,-29.3204462903455,16.8174,12.8794,6
"2624",1,21,8,-13,-22.0211410963093,7.8174,6.8794,3
"2625",1,24,6,-18,-27.0401473214224,12.8174,8.8794,6
"2626",1,26,30,4,-15.2316380240156,-9.1826,-15.1206,8
"2627",1,19,10,-9,-18.2026606135048,3.8174,4.8794,1
"2628",1,27,12,-15,-27.7007675876445,9.8174,2.8794,9
"2629",1,23,11,-12,-22.6624811661181,6.8174,3.8794,5
"2630",1,16,24,8,-6.09333296995123,-13.1826,-9.1206,-2
"2631",1,19,13,-6,-16.3442445118601,0.8174,1.8794,1
"2632",1,13,21,8,-3.90982495603863,-13.1826,-6.1206,-5
"2633",1,22,3,-19,-26.5075306143971,13.8174,11.8794,4
"2634",1,20,12,-8,-18.312098546459,2.8174,2.8794,2
"2635",1,19,0,-19,-24.2935931595082,13.8174,14.8794,1
"2636",1,26,0,-26,-33.5216973155032,20.8174,14.8794,8
"2637",1,16,21,5,-7.45359124480093,-10.1826,-6.1206,-2
"2638",1,18,19,1,-11.7174488286937,-6.1826,-4.1206,0
"2639",1,12,24,12,-0.794770676371791,-17.1826,-9.1206,-6
"2640",1,30,2,-28,-37.4578641740151,22.8174,12.8794,12
"2641",1,19,7,-12,-19.9114347207687,6.8174,7.8794,1
"2642",1,26,9,-17,-27.8953944894406,11.8174,5.8794,8
"2643",1,22,0,-22,-28.0248453875303,16.8174,14.8794,4
"2644",1,17,16,-1,-12.0177837705405,-4.1826,-1.1206,-1
"2645",1,23,9,-14,-24.0429609288935,8.8174,5.8794,5
"2646",1,25,30,5,-14.2357548830282,-10.1826,-15.1206,7
"2647",1,26,14,-12,-24.5686589196196,6.8174,0.8794,8
"2648",1,23,16,-7,-19.9729123627701,1.8174,-1.1206,5
"2649",1,15,11,-4,-12.3043681602963,-1.1826,3.8794,-3
"2650",1,28,8,-20,-30.9898243285654,14.8174,6.8794,10
"2651",1,21,0,-21,-26.8424751014317,15.8174,14.8794,3
"2652",1,16,27,11,-4.08346818825694,-16.1826,-12.1206,-2
"2653",1,25,9,-16,-26.4338999689336,10.8174,5.8794,7
"2654",1,18,30,12,-5.15502522761875,-17.1826,-15.1206,0
"2655",1,23,27,4,-13.1730371216158,-9.1826,-12.1206,5
"2656",1,10,23,13,1.01451105724651,-18.1826,-8.1206,-8
"2657",1,19,22,3,-10.8363814659006,-8.1826,-7.1206,1
"2658",1,18,8,-10,-18.0991230896006,4.8174,6.8794,0
"2659",1,9,16,7,-1.66834183384519,-12.1826,-1.1206,-9
"2660",1,16,22,6,-7.09314338902698,-11.1826,-7.1206,-2
"2661",1,28,27,-1,-19.8128518364221,-4.1826,-12.1206,10
"2662",1,21,16,-5,-17.282263684281,-0.1826,-1.1206,3
"2663",1,22,29,7,-10.9014445347634,-12.1826,-14.1206,4
"2664",1,26,20,-6,-21.3007665355038,0.8174,-5.1206,8
"2665",1,22,27,5,-12.2548561660768,-10.1826,-12.1206,4
"2666",1,14,3,-11,-15.9031762980636,5.8174,11.8794,-4
"2667",1,21,20,-1,-14.8328531729474,-4.1826,-5.1206,3
"2668",1,21,28,7,-10.03854988061,-12.1826,-13.1206,3
"2669",1,24,5,-19,-27.888197423064,13.8174,9.8794,6
"2670",1,18,14,-4,-14.418047401595,-1.1826,0.8794,0
"2671",1,20,26,6,-10.085508369019,-11.1826,-11.1206,2
"2672",1,15,23,8,-5.07557086186776,-13.1826,-8.1206,-3
"2673",1,23,21,-2,-16.5182027593081,-3.1826,-6.1206,5
"2674",1,22,12,-10,-21.0123558506227,4.8174,2.8794,4
"2675",1,7,30,23,9.09783664016626,-28.1826,-15.1206,-11
"2676",1,20,8,-12,-20.8479068143701,6.8174,6.8794,2
"2677",1,25,30,5,-14.1403750493958,-10.1826,-15.1206,7
"2678",1,18,28,10,-6.01836129253924,-15.1826,-13.1206,0
"2679",1,12,0,-12,-15.0455591432561,6.8174,14.8794,-6
"2680",1,22,1,-21,-27.5783655365648,15.8174,13.8794,4
"2681",1,15,27,12,-2.7083628648028,-17.1826,-12.1206,-3
"2682",1,19,20,1,-12.3695486841672,-6.1826,-5.1206,1
"2683",1,24,5,-19,-27.4555452934834,13.8174,9.8794,6
"2684",1,18,23,5,-8.85769586805766,-10.1826,-8.1206,0
"2685",1,20,1,-19,-25.0046683103245,13.8174,13.8794,2
"2686",1,16,11,-5,-13.5422308126723,-0.1826,3.8794,-2
"2687",1,18,11,-7,-16.4480115732369,1.8174,3.8794,0
"2688",1,28,24,-4,-21.2702669634324,-1.1826,-9.1206,10
"2689",1,20,29,9,-8.19614229841399,-14.1826,-14.1206,2
"2690",1,12,13,1,-7.11882338720997,-6.1826,1.8794,-6
"2691",1,21,6,-15,-23.2538389585995,9.8174,8.8794,3
"2692",1,23,0,-23,-29.5229385759305,17.8174,14.8794,5
"2693",1,17,26,9,-6.13603609425157,-14.1826,-11.1206,-1
"2694",1,24,10,-14,-24.7961461253394,8.8174,4.8794,6
"2695",1,18,10,-8,-16.8469842405807,2.8174,4.8794,0
"2696",1,13,20,7,-4.22421874712521,-12.1826,-5.1206,-5
"2697",1,32,5,-27,-38.3299091624885,21.8174,9.8794,14
"2698",1,26,0,-26,-33.272344496068,20.8174,14.8794,8
"2699",1,25,0,-25,-32.0342741220764,19.8174,14.8794,7
"2700",1,24,27,3,-14.4880109519001,-8.1826,-12.1206,6
"2701",1,19,0,-19,-23.9722444494171,13.8174,14.8794,1
"2702",1,22,28,6,-11.4993536106115,-11.1826,-13.1206,4
"2703",1,25,13,-12,-24.2415268730028,6.8174,1.8794,7
"2704",1,21,8,-13,-21.9776724963917,7.8174,6.8794,3
"2705",1,23,24,1,-15.1022813769527,-6.1826,-9.1206,5
"2706",1,25,1,-24,-31.4265755583496,18.8174,13.8794,7
"2707",1,23,28,5,-12.4322903808263,-10.1826,-13.1206,5
"2708",1,29,13,-16,-29.5390380937873,10.8174,1.8794,11
"2709",1,16,12,-4,-12.9736926358074,-1.1826,2.8794,-2
"2710",1,21,30,9,-8.7412084607614,-14.1826,-15.1206,3
"2711",1,13,15,2,-7.36057160412415,-7.1826,-0.1206,-5
"2712",1,23,20,-3,-17.6240619479665,-2.1826,-5.1206,5
"2713",1,26,15,-11,-24.2793847157899,5.8174,-0.1206,8
"2714",1,23,9,-14,-23.9816556154248,8.8174,5.8794,5
"2715",1,16,23,7,-6.83035520418049,-12.1826,-8.1206,-2
"2716",1,24,24,0,-16.4120607195893,-5.1826,-9.1206,6
"2717",1,18,8,-10,-18.1474478979005,4.8174,6.8794,0
"2718",1,17,2,-15,-20.1715950223341,9.8174,12.8794,-1
"2719",1,21,22,1,-13.4804657996143,-6.1826,-7.1206,3
"2720",1,16,8,-8,-15.3682560144836,2.8174,6.8794,-2
"2721",1,20,5,-15,-22.4818786902367,9.8174,9.8794,2
"2722",1,29,7,-22,-33.0626079801925,16.8174,7.8794,11
"2723",1,22,22,0,-14.8479253174497,-5.1826,-7.1206,4
"2724",1,22,22,0,-14.6607578811645,-5.1826,-7.1206,4
"2725",1,17,19,2,-10.3611271710897,-7.1826,-4.1206,-1
"2726",1,19,4,-15,-22.0713548750623,9.8174,10.8794,1
"2727",1,16,27,11,-4.03648402008196,-16.1826,-12.1206,-2
"2728",1,20,6,-14,-21.7549957976373,8.8174,8.8794,2
"2729",1,19,24,5,-9.9204994633576,-10.1826,-9.1206,1
"2730",1,20,29,9,-7.98967389066107,-14.1826,-14.1206,2
"2731",1,27,20,-7,-22.4212555299453,1.8174,-5.1206,9
"2732",1,26,26,0,-17.5516451866504,-5.1826,-11.1206,8
"2733",1,15,18,3,-8.31350853279355,-8.1826,-3.1206,-3
"2734",1,22,18,-4,-17.2936760707178,-1.1826,-3.1206,4
"2735",1,24,10,-14,-24.7122962045206,8.8174,4.8794,6
"2736",1,17,7,-10,-17.4354242508314,4.8174,7.8794,-1
"2737",1,25,21,-4,-19.4083902639552,-1.1826,-6.1206,7
"2738",1,19,5,-14,-21.0454954396456,8.8174,9.8794,1
"2739",1,19,8,-11,-19.5343665356256,5.8174,6.8794,1
"2740",1,24,0,-24,-30.8021929814291,18.8174,14.8794,6
"2741",1,28,25,-3,-20.898109607133,-2.1826,-10.1206,10
"2742",1,21,15,-6,-17.585616978418,0.8174,-0.1206,3
"2743",1,19,20,1,-12.1358821583589,-6.1826,-5.1206,1
"2744",1,21,24,3,-12.4532392355796,-8.1826,-9.1206,3
"2745",1,19,20,1,-12.3213990738894,-6.1826,-5.1206,1
"2746",1,20,17,-3,-15.5467274407693,-2.1826,-2.1206,2
"2747",1,33,0,-33,-42.3941245241339,27.8174,14.8794,15
"2748",1,21,18,-3,-15.7923071813686,-2.1826,-3.1206,3
"2749",1,16,17,1,-10.0800879171314,-6.1826,-2.1206,-2
"2750",1,16,3,-13,-18.4658382397793,7.8174,11.8794,-2
"2751",1,22,29,7,-10.7337296907192,-12.1826,-14.1206,4
"2752",1,30,12,-18,-31.3919533744311,12.8174,2.8794,12
"2753",1,10,17,7,-2.41868615332156,-12.1826,-2.1206,-8
"2754",1,23,30,7,-11.4528550361894,-12.1826,-15.1206,5
"2755",1,22,4,-18,-25.5832198512984,12.8174,10.8794,4
"2756",1,24,30,6,-12.9000970581784,-11.1826,-15.1206,6
"2757",1,16,4,-12,-17.9487270650241,6.8174,10.8794,-2
"2758",1,20,4,-16,-23.3501606548818,10.8174,10.8794,2
"2759",1,20,14,-6,-16.9194228497659,0.8174,0.8794,2
"2760",1,18,4,-14,-20.3306177343617,8.8174,10.8794,0
"2761",1,15,20,5,-6.94567604915002,-10.1826,-5.1206,-3
"2762",1,22,15,-7,-19.301433139523,1.8174,-0.1206,4
"2763",1,22,23,1,-14.1588332013766,-6.1826,-8.1206,4
"2764",1,16,25,9,-5.39983307809671,-14.1826,-10.1206,-2
"2765",1,24,22,-2,-17.4281920563035,-3.1826,-7.1206,6
"2766",1,21,5,-16,-23.8263916756424,10.8174,9.8794,3
"2767",1,12,30,18,2.81112849500018,-23.1826,-15.1206,-6
"2768",1,17,3,-14,-19.7679546317769,8.8174,11.8794,-1
"2769",1,20,16,-4,-15.5634569964618,-1.1826,-1.1206,2
"2770",1,29,24,-5,-23.1677889994954,-0.1826,-9.1206,11
"2771",1,23,4,-19,-26.8192608456372,13.8174,10.8794,5
"2772",1,16,29,13,-2.7756855228484,-18.1826,-14.1206,-2
"2773",1,18,27,9,-6.66608837239282,-14.1826,-12.1206,0
"2774",1,19,8,-11,-19.4554162269883,5.8174,6.8794,1
"2775",1,15,30,15,-1.18261508816765,-20.1826,-15.1206,-3
"2776",1,22,30,8,-9.87160276508827,-13.1826,-15.1206,4
"2777",1,17,19,2,-10.1581696803265,-7.1826,-4.1206,-1
"2778",1,19,30,11,-6.21942359581326,-16.1826,-15.1206,1
"2779",1,24,15,-9,-21.5804772680977,3.8174,-0.1206,6
"2780",1,21,27,6,-10.7612556267212,-11.1826,-12.1206,3
"2781",1,16,3,-13,-18.4808579713557,7.8174,11.8794,-2
"2782",1,18,1,-17,-22.441057415338,11.8174,13.8794,0
"2783",1,21,13,-8,-18.7741061894653,2.8174,1.8794,3
"2784",1,17,12,-5,-14.6674087677902,-0.1826,2.8794,-1
"2785",1,31,2,-29,-38.5818891398278,23.8174,12.8794,13
"2786",1,20,26,6,-9.82774293749445,-11.1826,-11.1206,2
"2787",1,22,24,2,-13.6710989842855,-7.1826,-9.1206,4
"2788",1,16,2,-14,-18.9793972132914,8.8174,12.8794,-2
"2789",1,16,15,-1,-11.0081895380232,-4.1826,-0.1206,-2
"2790",1,25,17,-8,-21.6274072376468,2.8174,-2.1206,7
"2791",1,26,29,3,-15.7855056269532,-8.1826,-14.1206,8
"2792",1,11,29,18,3.61816600626546,-23.1826,-14.1206,-7
"2793",1,27,26,-1,-19.1181940914969,-4.1826,-11.1206,9
"2794",1,20,24,4,-11.1991326735124,-9.1826,-9.1206,2
"2795",1,23,19,-4,-18.0228208003778,-1.1826,-4.1206,5
"2796",1,17,29,12,-4.1113230339308,-17.1826,-14.1206,-1
"2797",1,17,24,7,-7.03193031351375,-12.1826,-9.1206,-1
"2798",1,24,13,-11,-22.7716424786227,5.8174,1.8794,6
"2799",1,11,26,15,1.79340854067131,-20.1826,-11.1206,-7
"2800",1,15,20,5,-7.04613980496391,-10.1826,-5.1206,-3
"2801",1,24,18,-6,-19.892441917369,0.8174,-3.1206,6
"2802",1,12,7,-5,-10.752003783021,-0.1826,7.8794,-6
"2803",1,24,11,-13,-24.0689421230173,7.8174,3.8794,6
"2804",1,20,10,-10,-19.5882355144215,4.8174,4.8794,2
"2805",1,18,27,9,-6.43926273816656,-14.1826,-12.1206,0
"2806",1,15,26,11,-3.20039140903965,-16.1826,-11.1206,-3
"2807",1,17,15,-2,-12.4278237685019,-3.1826,-0.1206,-1
"2808",1,15,7,-8,-14.8414270314095,2.8174,7.8794,-3
"2809",1,21,23,2,-13.203374800027,-7.1826,-8.1206,3
"2810",1,18,4,-14,-20.6314580326113,8.8174,10.8794,0
"2811",1,21,11,-10,-20.6462052750972,4.8174,3.8794,3
"2812",1,23,10,-13,-23.0629666062779,7.8174,4.8794,5
"2813",1,8,0,-8,-9.82264691296422,2.8174,14.8794,-10
"2814",1,25,15,-10,-22.9889939593434,4.8174,-0.1206,7
"2815",1,17,27,10,-5.33806224032995,-15.1826,-12.1206,-1
"2816",1,19,7,-12,-19.9633798393499,6.8174,7.8794,1
"2817",1,24,11,-13,-24.1772165633586,7.8174,3.8794,6
"2818",1,22,29,7,-10.8639509479873,-12.1826,-14.1206,4
"2819",1,18,12,-6,-15.7238217167476,0.8174,2.8794,0
"2820",1,20,25,5,-10.4386546137062,-10.1826,-10.1206,2
"2821",1,20,30,10,-7.51750339443121,-15.1826,-15.1206,2
"2822",1,24,27,3,-14.646329430203,-8.1826,-12.1206,6
"2823",1,23,4,-19,-26.9155412351772,13.8174,10.8794,5
"2824",1,31,13,-18,-32.1122957327377,12.8174,1.8794,13
"2825",1,20,10,-10,-19.5873798096435,4.8174,4.8794,2
"2826",1,15,14,-1,-10.7036619317534,-4.1826,0.8794,-3
"2827",1,15,29,14,-1.4078377133789,-19.1826,-14.1206,-3
"2828",1,22,5,-17,-25.2526743560476,11.8174,9.8794,4
"2829",1,20,13,-7,-17.7034135679507,1.8174,1.8794,2
"2830",1,22,10,-12,-21.7969140999479,6.8174,4.8794,4
"2831",1,18,2,-16,-21.6174272067332,10.8174,12.8794,0
"2832",1,20,12,-8,-18.218021294868,2.8174,2.8794,2
"2833",1,23,5,-18,-26.2745868798869,12.8174,9.8794,5
"2834",1,24,3,-21,-28.8920626317947,15.8174,11.8794,6
"2835",1,13,20,7,-4.30910068083544,-12.1826,-5.1206,-5
"2836",1,25,1,-24,-31.3134953553706,18.8174,13.8794,7
"2837",1,25,3,-22,-30.2288359437574,16.8174,11.8794,7
"2838",1,13,8,-5,-11.5060413786156,-0.1826,6.8794,-5
"2839",1,19,9,-10,-18.9340323666564,4.8174,5.8794,1
"2840",1,26,8,-18,-28.4903976453274,12.8174,6.8794,8
"2841",1,23,5,-18,-26.1754615688969,12.8174,9.8794,5
"2842",1,13,25,12,-1.29547289619628,-17.1826,-10.1206,-5
"2843",1,22,15,-7,-19.3707444552532,1.8174,-0.1206,4
"2844",1,23,22,-1,-16.2076007670648,-4.1826,-7.1206,5
"2845",1,22,20,-2,-16.1149998426405,-3.1826,-5.1206,4
"2846",1,27,17,-10,-24.2712711150504,4.8174,-2.1206,9
"2847",1,17,25,8,-6.77510741842086,-13.1826,-10.1206,-1
"2848",1,20,20,0,-13.4847925114459,-5.1826,-5.1206,2
"2849",1,21,1,-20,-26.0742019430045,14.8174,13.8794,3
"2850",1,17,26,9,-5.96758559281821,-14.1826,-11.1206,-1
"2851",1,19,1,-18,-23.6048640741334,12.8174,13.8794,1
"2852",1,23,1,-22,-28.8776747141304,16.8174,13.8794,5
"2853",1,26,5,-21,-30.3618397930844,15.8174,9.8794,8
"2854",1,25,16,-9,-22.2472069196211,3.8174,-1.1206,7
"2855",1,18,4,-14,-20.661874682655,8.8174,10.8794,0
"2856",1,12,16,4,-5.44994301547138,-9.1826,-1.1206,-6
"2857",1,13,27,14,-0.217225051817284,-19.1826,-12.1206,-5
"2858",1,14,7,-7,-13.7129389575515,1.8174,7.8794,-4
"2859",1,22,7,-15,-23.7189490626595,9.8174,7.8794,4
"2860",1,16,0,-16,-20.2491703761378,10.8174,14.8794,-2
"2861",1,18,9,-9,-17.4254551106881,3.8174,5.8794,0
"2862",1,25,1,-24,-31.1620052871107,18.8174,13.8794,7
"2863",1,14,21,7,-4.98700687259005,-12.1826,-6.1206,-4
"2864",1,20,23,3,-11.8125452424732,-8.1826,-8.1206,2
"2865",1,16,23,7,-6.57301267245822,-12.1826,-8.1206,-2
"2866",1,18,18,0,-11.9466462971177,-5.1826,-3.1206,0
"2867",1,31,27,-4,-23.5272975657159,-1.1826,-12.1206,13
"2868",1,13,6,-7,-12.8508269426778,1.8174,8.8794,-5
"2869",1,20,8,-12,-20.5495301229506,6.8174,6.8794,2
"2870",1,17,27,10,-5.35865379751802,-15.1826,-12.1206,-1
"2871",1,24,13,-11,-22.9858360574786,5.8174,1.8794,6
"2872",1,24,11,-13,-24.0745558336275,7.8174,3.8794,6
"2873",1,18,27,9,-6.88843577774912,-14.1826,-12.1206,0
"2874",1,22,27,5,-11.8702514498561,-10.1826,-12.1206,4
"2875",1,31,22,-9,-26.4866487658713,3.8174,-7.1206,13
"2876",1,26,7,-19,-29.1966629802071,13.8174,7.8794,8
"2877",1,23,0,-23,-29.5840423689994,17.8174,14.8794,5
"2878",1,19,12,-7,-17.0722503963648,1.8174,2.8794,1
"2879",1,24,8,-16,-25.7209031387068,10.8174,6.8794,6
"2880",1,29,5,-24,-34.4900768684213,18.8174,9.8794,11
"2881",1,20,18,-2,-14.863167740042,-3.1826,-3.1206,2
"2882",1,12,13,1,-7.4233249492437,-6.1826,1.8794,-6
"2883",1,23,1,-22,-29.0433098378472,16.8174,13.8794,5
"2884",1,25,10,-15,-25.9258252604712,9.8174,4.8794,7
"2885",1,33,2,-31,-41.13502326258,25.8174,12.8794,15
"2886",1,18,20,2,-11.0783156502812,-7.1826,-5.1206,0
"2887",1,13,5,-8,-13.3829144717814,2.8174,9.8794,-5
"2888",1,12,21,9,-2.41538083359276,-14.1826,-6.1206,-6
"2889",1,23,29,6,-12.0718829342815,-11.1826,-14.1206,5
"2890",1,23,18,-5,-18.4576293130164,-0.1826,-3.1206,5
"2891",1,19,18,-1,-13.2374753411018,-4.1826,-3.1206,1
"2892",1,13,7,-6,-12.3854833442291,0.8174,7.8794,-5
"2893",1,20,2,-18,-24.3239819728215,12.8174,12.8794,2
"2894",1,25,8,-17,-27.2919081594922,11.8174,6.8794,7
"2895",1,22,9,-13,-22.4785617512382,7.8174,5.8794,4
"2896",1,30,22,-8,-25.3751100959045,2.8174,-7.1206,12
"2897",1,24,27,3,-14.3607833069067,-8.1826,-12.1206,6
"2898",1,26,25,-1,-18.3988119554261,-4.1826,-10.1206,8
"2899",1,14,1,-13,-17.0625772574207,7.8174,13.8794,-4
"2900",1,16,4,-12,-18.1678261238833,6.8174,10.8794,-2
"2901",1,21,19,-2,-15.4594542629415,-3.1826,-4.1206,3
"2902",1,27,20,-7,-22.7696363807205,1.8174,-5.1206,9
"2903",1,20,21,1,-12.7558585804034,-6.1826,-6.1206,2
"2904",1,24,27,3,-14.5646924001076,-8.1826,-12.1206,6
"2905",1,19,7,-12,-20.0966195503129,6.8174,7.8794,1
"2906",1,18,7,-11,-18.8784341150124,5.8174,7.8794,0
"2907",1,28,4,-24,-33.6126561241424,18.8174,10.8794,10
"2908",1,20,30,10,-7.54977270319689,-15.1826,-15.1206,2
"2909",1,22,7,-15,-23.6865566432441,9.8174,7.8794,4
"2910",1,17,12,-5,-14.2230999079943,-0.1826,2.8794,-1
"2911",1,24,23,-1,-16.6257768078138,-4.1826,-8.1206,6
"2912",1,21,27,6,-10.6274731701363,-11.1826,-12.1206,3
"2913",1,20,3,-17,-23.6785613171658,11.8174,11.8794,2
"2914",1,27,11,-16,-27.891704164005,10.8174,3.8794,9
"2915",1,18,27,9,-6.72087355644006,-14.1826,-12.1206,0
"2916",1,20,10,-10,-19.6796887895568,4.8174,4.8794,2
"2917",1,25,16,-9,-22.430200642917,3.8174,-1.1206,7
"2918",1,20,7,-13,-21.4707555573536,7.8174,7.8794,2
"2919",1,23,21,-2,-16.9869944703811,-3.1826,-6.1206,5
"2920",1,14,17,3,-7.29513851969037,-8.1826,-2.1206,-4
"2921",1,16,0,-16,-20.2975864669315,10.8174,14.8794,-2
"2922",1,20,2,-18,-24.3588799429471,12.8174,12.8794,2
"2923",1,20,29,9,-8.32028628701303,-14.1826,-14.1206,2
"2924",1,21,2,-19,-25.6935539771122,13.8174,12.8794,3
"2925",1,16,15,-1,-11.3149488131746,-4.1826,-0.1206,-2
"2926",1,16,11,-5,-13.1743974793007,-0.1826,3.8794,-2
"2927",1,21,13,-8,-19.1518291532429,2.8174,1.8794,3
"2928",1,16,24,8,-5.7750935961391,-13.1826,-9.1206,-2
"2929",1,14,25,11,-2.68942998818307,-16.1826,-10.1206,-4
"2930",1,21,0,-21,-26.878393878223,15.8174,14.8794,3
"2931",1,29,7,-22,-32.9935153667921,16.8174,7.8794,11
"2932",1,21,18,-3,-15.9193685875754,-2.1826,-3.1206,3
"2933",1,23,8,-15,-24.7107023093765,9.8174,6.8794,5
"2934",1,23,30,7,-11.3357147532415,-12.1826,-15.1206,5
"2935",1,23,26,3,-13.7352569251144,-8.1826,-11.1206,5
"2936",1,20,23,3,-11.902402804551,-8.1826,-8.1206,2
"2937",1,18,14,-4,-14.4036275637323,-1.1826,0.8794,0
"2938",1,17,2,-15,-20.4326074735283,9.8174,12.8794,-1
"2939",1,23,3,-20,-27.6772424689221,14.8174,11.8794,5
"2940",1,16,8,-8,-15.4434975827148,2.8174,6.8794,-2
"2941",1,22,2,-20,-26.9325491696035,14.8174,12.8794,4
"2942",1,15,8,-7,-14.1687888869807,1.8174,6.8794,-3
"2943",1,18,6,-12,-19.328756680265,6.8174,8.8794,0
"2944",1,17,30,13,-3.64042776218616,-18.1826,-15.1206,-1
"2945",1,16,4,-12,-18.3148294539048,6.8174,10.8794,-2
"2946",1,16,16,0,-10.5298409110603,-5.1826,-1.1206,-2
"2947",1,11,14,3,-5.38098439197721,-8.1826,0.8794,-7
"2948",1,21,23,2,-12.7669609932284,-7.1826,-8.1206,3
"2949",1,15,24,9,-4.69023739698356,-14.1826,-9.1206,-3
"2950",1,22,11,-11,-21.3539208383412,5.8174,3.8794,4
"2951",1,27,28,1,-17.7311380097151,-6.1826,-13.1206,9
"2952",1,9,2,-7,-9.94219835396914,1.8174,12.8794,-9
"2953",1,21,2,-19,-25.747131343639,13.8174,12.8794,3
"2954",1,18,16,-2,-13.1287001504448,-3.1826,-1.1206,0
"2955",1,19,22,3,-10.9732384825476,-8.1826,-7.1206,1
"2956",1,17,22,5,-8.49419281733719,-10.1826,-7.1206,-1
"2957",1,24,3,-21,-29.0783210782078,15.8174,11.8794,6
"2958",1,16,30,14,-2.42362385801727,-19.1826,-15.1206,-2
"2959",1,15,22,7,-5.84016209930574,-12.1826,-7.1206,-3
"2960",1,25,27,2,-15.9110809287911,-7.1826,-12.1206,7
"2961",1,25,20,-5,-20.0707570923215,-0.1826,-5.1206,7
"2962",1,21,21,0,-14.1971156350045,-5.1826,-6.1206,3
"2963",1,26,2,-24,-32.1688981924541,18.8174,12.8794,8
"2964",1,13,0,-13,-16.3490493608301,7.8174,14.8794,-5
"2965",1,20,17,-3,-15.3857935553583,-2.1826,-2.1206,2
"2966",1,27,19,-8,-23.0727992313739,2.8174,-4.1206,9
"2967",1,17,19,2,-10.0584132329466,-7.1826,-4.1206,-1
"2968",1,19,4,-15,-21.7627988892246,9.8174,10.8794,1
"2969",1,22,12,-10,-21.0718916375225,4.8174,2.8794,4
"2970",1,23,30,7,-11.5657923329044,-12.1826,-15.1206,5
"2971",1,13,21,8,-3.91949146466013,-13.1826,-6.1206,-5
"2972",1,18,14,-4,-14.5828076746167,-1.1826,0.8794,0
"2973",1,20,29,9,-8.06087204757985,-14.1826,-14.1206,2
"2974",1,18,26,8,-7.37596156585903,-13.1826,-11.1206,0
"2975",1,26,22,-4,-19.7369581558284,-1.1826,-7.1206,8
"2976",1,22,29,7,-10.9062305472551,-12.1826,-14.1206,4
"2977",1,26,9,-17,-27.6348070229062,11.8174,5.8794,8
"2978",1,14,19,5,-6.38566665851596,-10.1826,-4.1206,-4
"2979",1,19,16,-3,-14.5873119619428,-2.1826,-1.1206,1
"2980",1,21,24,3,-12.4206361841503,-8.1826,-9.1206,3
"2981",1,22,7,-15,-23.6931297643942,9.8174,7.8794,4
"2982",1,22,30,8,-10.2185752588852,-13.1826,-15.1206,4
"2983",1,11,9,-2,-8.33235885532492,-3.1826,5.8794,-7
"2984",1,19,18,-1,-13.3092185778781,-4.1826,-3.1206,1
"2985",1,21,13,-8,-18.8461385620849,2.8174,1.8794,3
"2986",1,24,28,4,-13.826749500333,-9.1826,-13.1206,6
"2987",1,15,9,-6,-13.7323346971122,0.8174,5.8794,-3
"2988",1,28,9,-19,-30.5589278060989,13.8174,5.8794,10
"2989",1,19,6,-13,-20.452339075645,7.8174,8.8794,1
"2990",1,11,15,4,-4.86740183964985,-9.1826,-0.1206,-7
"2991",1,19,1,-18,-23.6969698595743,12.8174,13.8794,1
"2992",1,14,7,-7,-13.4605429799822,1.8174,7.8794,-4
"2993",1,29,9,-20,-31.9649159594009,14.8174,5.8794,11
"2994",1,17,14,-3,-12.8029927514938,-2.1826,0.8794,-1
"2995",1,19,22,3,-10.8686856048848,-8.1826,-7.1206,1
"2996",1,20,29,9,-8.27789330042925,-14.1826,-14.1206,2
"2997",1,16,22,6,-7.43795900417022,-11.1826,-7.1206,-2
"2998",1,22,14,-8,-19.4831290460582,2.8174,0.8794,4
"2999",1,16,21,5,-7.87227094639046,-10.1826,-6.1206,-2
"3000",1,18,8,-10,-18.5678600143485,4.8174,6.8794,0
"3001",1,15,9,-6,-13.4852771069353,0.8174,5.8794,-3
"3002",1,22,3,-19,-26.5651666221663,13.8174,11.8794,4
"3003",1,20,25,5,-10.4352967335863,-10.1826,-10.1206,2
"3004",1,26,10,-16,-27.1632141898371,10.8174,4.8794,8
"3005",1,23,25,2,-14.3799568841154,-7.1826,-10.1206,5
"3006",1,19,28,9,-7.62346693080821,-14.1826,-13.1206,1
"3007",1,16,30,14,-2.13878637917633,-19.1826,-15.1206,-2
"3008",1,16,1,-15,-19.7298475984594,9.8174,13.8794,-2
"3009",1,25,11,-14,-25.5575013475496,8.8174,3.8794,7
"3010",1,26,9,-17,-28.0040207526563,11.8174,5.8794,8
"3011",1,21,2,-19,-25.6575797467817,13.8174,12.8794,3
"3012",1,16,23,7,-6.37059486954902,-12.1826,-8.1206,-2
"3013",1,23,24,1,-14.7353859416885,-6.1826,-9.1206,5
"3014",1,29,23,-6,-23.3000966917615,0.8174,-8.1206,11
"3015",1,15,15,0,-9.79369508860494,-5.1826,-0.1206,-3
"3016",1,26,22,-4,-20.0810725575986,-1.1826,-7.1206,8
"3017",1,15,7,-8,-14.9098988912157,2.8174,7.8794,-3
"3018",1,19,11,-8,-17.4433030125066,2.8174,3.8794,1
"3019",1,21,3,-18,-25.1621187809809,12.8174,11.8794,3
"3020",1,21,28,7,-10.025108414013,-12.1826,-13.1206,3
"3021",1,16,28,12,-3.55512131040903,-17.1826,-13.1206,-2
"3022",1,23,26,3,-13.8667060558887,-8.1826,-11.1206,5
"3023",1,20,4,-16,-23.0643591077874,10.8174,10.8794,2
"3024",1,27,25,-2,-19.5198341618411,-3.1826,-10.1206,9
"3025",1,24,30,6,-12.433785019279,-11.1826,-15.1206,6
"3026",1,23,11,-12,-23.000048025325,6.8174,3.8794,5
"3027",1,14,1,-13,-17.0500177784714,7.8174,13.8794,-4
"3028",1,24,21,-3,-17.8296370590017,-2.1826,-6.1206,6
"3029",1,17,7,-10,-17.146757359513,4.8174,7.8794,-1
"3030",1,18,17,-1,-12.3601249031973,-4.1826,-2.1206,0
"3031",1,21,3,-18,-24.7935918930975,12.8174,11.8794,3
"3032",1,21,21,0,-14.0021567837129,-5.1826,-6.1206,3
"3033",1,24,7,-17,-26.4183499943195,11.8174,7.8794,6
"3034",1,28,20,-8,-23.75276309247,2.8174,-5.1206,10
"3035",1,20,10,-10,-19.7616276948186,4.8174,4.8794,2
"3036",1,29,6,-23,-33.1669446523969,17.8174,8.8794,11
"3037",1,23,6,-17,-25.5534539060836,11.8174,8.8794,5
"3038",1,23,27,4,-13.1684320186114,-9.1826,-12.1206,5
"3039",1,20,28,8,-8.81220837124702,-13.1826,-13.1206,2
"3040",1,24,14,-10,-22.4493466752778,4.8174,0.8794,6
"3041",1,27,21,-6,-21.806861685502,0.8174,-6.1206,9
"3042",1,16,23,7,-6.32276997070683,-12.1826,-8.1206,-2
"3043",1,20,9,-11,-20.2613750372232,5.8174,5.8794,2
"3044",1,21,13,-8,-19.0746456725165,2.8174,1.8794,3
"3045",1,14,18,4,-7.11748190495043,-9.1826,-3.1206,-4
"3046",1,22,14,-8,-19.715564676693,2.8174,0.8794,4
"3047",1,18,27,9,-6.54043751990977,-14.1826,-12.1206,0
"3048",1,20,26,6,-9.84698781211277,-11.1826,-11.1206,2
"3049",1,21,11,-10,-20.2340410309251,4.8174,3.8794,3
"3050",1,14,28,14,-0.901135624154368,-19.1826,-13.1206,-4
"3051",1,21,9,-12,-21.5845132690346,6.8174,5.8794,3
"3052",1,20,20,0,-13.6248311766173,-5.1826,-5.1206,2
"3053",1,28,3,-25,-34.0578712643339,19.8174,11.8794,10
"3054",1,12,9,-3,-9.63071330268912,-2.1826,5.8794,-6
"3055",1,14,17,3,-7.24255453111987,-8.1826,-2.1206,-4
"3056",1,17,17,0,-11.3739485108308,-5.1826,-2.1206,-1
"3057",1,25,23,-2,-18.396251025393,-3.1826,-8.1206,7
"3058",1,13,6,-7,-12.6746871689989,1.8174,8.8794,-5
"3059",1,18,5,-13,-19.952386217371,7.8174,9.8794,0
"3060",1,18,5,-13,-20.2824244351696,7.8174,9.8794,0
"3061",1,25,27,2,-15.8841424641242,-7.1826,-12.1206,7
"3062",1,18,2,-16,-21.5749330738622,10.8174,12.8794,0
"3063",1,16,1,-15,-19.7977171714448,9.8174,13.8794,-2
"3064",1,22,20,-2,-15.9001705466252,-3.1826,-5.1206,4
"3065",1,16,13,-3,-12.5007176330253,-2.1826,1.8794,-2
"3066",1,22,20,-2,-16.2797534100844,-3.1826,-5.1206,4
"3067",1,22,12,-10,-21.0796004587553,4.8174,2.8794,4
"3068",1,17,20,3,-9.52065944976678,-8.1826,-5.1206,-1
"3069",1,16,4,-12,-18.167816288805,6.8174,10.8794,-2
"3070",1,25,10,-15,-25.9877478417506,9.8174,4.8794,7
"3071",1,17,2,-15,-20.2695437415453,9.8174,12.8794,-1
"3072",1,22,12,-10,-20.9837936328881,4.8174,2.8794,4
"3073",1,15,11,-4,-11.9920899171099,-1.1826,3.8794,-3
"3074",1,14,8,-6,-12.8575985957115,0.8174,6.8794,-4
"3075",1,20,1,-19,-24.9714073035982,13.8174,13.8794,2
"3076",1,20,30,10,-7.26166404001199,-15.1826,-15.1206,2
"3077",1,21,17,-4,-16.3946798377605,-1.1826,-2.1206,3
"3078",1,29,29,0,-19.6589847542782,-5.1826,-14.1206,11
"3079",1,12,26,14,0.556632653013613,-19.1826,-11.1206,-6
"3080",1,17,8,-9,-16.7931750221839,3.8174,6.8794,-1
"3081",1,20,30,10,-7.57644538601564,-15.1826,-15.1206,2
"3082",1,15,24,9,-4.3556223286563,-14.1826,-9.1206,-3
"3083",1,24,28,4,-14.0320903581394,-9.1826,-13.1206,6
"3084",1,17,9,-8,-16.1946134058732,2.8174,5.8794,-1
"3085",1,31,9,-22,-34.4888353726341,16.8174,5.8794,13
"3086",1,27,14,-13,-26.1121709752036,7.8174,0.8794,9
"3087",1,15,17,2,-8.98879205026148,-7.1826,-2.1206,-3
"3088",1,21,16,-5,-16.9759455061975,-0.1826,-1.1206,3
"3089",1,21,26,5,-10.9453585983131,-10.1826,-11.1206,3
"3090",1,18,27,9,-6.87887893960682,-14.1826,-12.1206,0
"3091",1,21,9,-12,-21.3154407582124,6.8174,5.8794,3
"3092",1,19,1,-18,-23.4956694254311,12.8174,13.8794,1
"3093",1,13,19,6,-5.06675332626429,-11.1826,-4.1206,-5
"3094",1,22,4,-18,-25.8041275029874,12.8174,10.8794,4
"3095",1,19,28,9,-7.56084955844666,-14.1826,-13.1206,1
"3096",1,26,22,-4,-20.10826466647,-1.1826,-7.1206,8
"3097",1,17,19,2,-10.1813623838634,-7.1826,-4.1206,-1
"3098",1,26,25,-1,-18.2169975116874,-4.1826,-10.1206,8
"3099",1,17,4,-13,-19.3625477897079,7.8174,10.8794,-1
"3100",1,23,0,-23,-29.1625423736336,17.8174,14.8794,5
"3101",1,22,29,7,-10.8251674111605,-12.1826,-14.1206,4
"3102",1,14,24,10,-3.28066020351002,-15.1826,-9.1206,-4
"3103",1,16,21,5,-7.66012897666868,-10.1826,-6.1206,-2
"3104",1,19,10,-9,-18.1921778737997,3.8174,4.8794,1
"3105",1,23,22,-1,-16.1516456600161,-4.1826,-7.1206,5
"3106",1,12,24,12,-0.546672470906513,-17.1826,-9.1206,-6
"3107",1,24,4,-20,-28.4022740121411,14.8174,10.8794,6
"3108",1,20,1,-19,-24.7026866557259,13.8174,13.8794,2
"3109",1,22,3,-19,-26.3474608947587,13.8174,11.8794,4
"3110",1,25,13,-12,-23.9972167932599,6.8174,1.8794,7
"3111",1,9,1,-8,-10.7106300398709,2.8174,13.8794,-9
"3112",1,22,27,5,-11.9618168375484,-10.1826,-12.1206,4
"3113",1,16,19,3,-9.12796062709544,-8.1826,-4.1206,-2
"3114",1,19,20,1,-12.2433987446837,-6.1826,-5.1206,1
"3115",1,18,25,7,-8.02643158054722,-12.1826,-10.1206,0
"3116",1,22,7,-15,-23.9061564162847,9.8174,7.8794,4
"3117",1,14,25,11,-2.74819535569591,-16.1826,-10.1206,-4
"3118",1,19,16,-3,-14.8677975591835,-2.1826,-1.1206,1
"3119",1,23,6,-17,-25.550045069282,11.8174,8.8794,5
"3120",1,19,4,-15,-21.7444701757771,9.8174,10.8794,1
"3121",1,18,30,12,-5.23610154455555,-17.1826,-15.1206,0
"3122",1,24,4,-20,-28.2638942681551,14.8174,10.8794,6
"3123",1,26,14,-12,-24.865496360924,6.8174,0.8794,8
"3124",1,24,25,1,-15.7518383571097,-6.1826,-10.1206,6
"3125",1,18,30,12,-4.7898701946071,-17.1826,-15.1206,0
"3126",1,19,9,-10,-18.6538496070122,4.8174,5.8794,1
"3127",1,12,22,10,-1.89634389300253,-15.1826,-7.1206,-6
"3128",1,16,22,6,-7.16065088662492,-11.1826,-7.1206,-2
"3129",1,18,2,-16,-21.5451375956106,10.8174,12.8794,0
"3130",1,19,16,-3,-14.8199961948463,-2.1826,-1.1206,1
"3131",1,22,25,3,-13.1664812248456,-8.1826,-10.1206,4
"3132",1,20,5,-15,-22.3523258594963,9.8174,9.8794,2
"3133",1,25,19,-6,-20.4865766572366,0.8174,-4.1206,7
"3134",1,25,5,-20,-29.1773593405841,14.8174,9.8794,7
"3135",1,18,27,9,-6.47666900624891,-14.1826,-12.1206,0
"3136",1,20,4,-16,-23.2395049380298,10.8174,10.8794,2
"3137",1,22,29,7,-10.4535966133685,-12.1826,-14.1206,4
"3138",1,25,9,-16,-27.017533849647,10.8174,5.8794,7
"3139",1,20,23,3,-11.7385194047749,-8.1826,-8.1206,2
"3140",1,18,14,-4,-14.6083852578387,-1.1826,0.8794,0
"3141",1,30,28,-2,-21.7657107812342,-3.1826,-13.1206,12
"3142",1,25,13,-12,-24.0264807772011,6.8174,1.8794,7
"3143",1,19,2,-17,-22.9621552831712,11.8174,12.8794,1
"3144",1,24,28,4,-14.1588272250544,-9.1826,-13.1206,6
"3145",1,22,26,4,-12.525650142625,-9.1826,-11.1206,4
"3146",1,20,29,9,-7.9436321839256,-14.1826,-14.1206,2
"3147",1,19,7,-12,-19.8153888357711,6.8174,7.8794,1
"3148",1,18,21,3,-10.2432595753636,-8.1826,-6.1206,0
"3149",1,14,19,5,-6.50959675417079,-10.1826,-4.1206,-4
"3150",1,22,8,-14,-23.1568122038811,8.8174,6.8794,4
"3151",1,19,26,7,-8.44573735058159,-12.1826,-11.1206,1
"3152",1,17,17,0,-11.4359893157065,-5.1826,-2.1206,-1
"3153",1,23,27,4,-13.1232779638899,-9.1826,-12.1206,5
"3154",1,26,6,-20,-29.41936633686,14.8174,8.8794,8
"3155",1,23,18,-5,-18.7260889587711,-0.1826,-3.1206,5
"3156",1,12,29,17,2.39339726732024,-22.1826,-14.1206,-6
"3157",1,14,8,-6,-12.6853935775405,0.8174,6.8794,-4
"3158",1,20,29,9,-7.95524380131919,-14.1826,-14.1206,2
"3159",1,22,0,-22,-28.2257336577215,16.8174,14.8794,4
"3160",1,16,4,-12,-17.7080577338348,6.8174,10.8794,-2
"3161",1,15,28,13,-2.32763192571848,-18.1826,-13.1206,-3
"3162",1,25,2,-23,-30.8514931715222,17.8174,12.8794,7
"3163",1,27,4,-23,-31.9953115019498,17.8174,10.8794,9
"3164",1,22,21,-1,-15.4460447180736,-4.1826,-6.1206,4
"3165",1,24,28,4,-13.9155752656252,-9.1826,-13.1206,6
"3166",1,17,29,12,-4.11534405105909,-17.1826,-14.1206,-1
"3167",1,14,6,-8,-14.1135680341608,2.8174,8.8794,-4
"3168",1,19,17,-2,-13.7096232048925,-3.1826,-2.1206,1
"3169",1,23,2,-21,-28.0129532411495,15.8174,12.8794,5
"3170",1,21,6,-15,-23.0381893057396,9.8174,8.8794,3
"3171",1,20,7,-13,-21.2786840489796,7.8174,7.8794,2
"3172",1,23,11,-12,-22.764689823193,6.8174,3.8794,5
"3173",1,22,26,4,-12.7640459649245,-9.1826,-11.1206,4
"3174",1,21,19,-2,-15.2202075744743,-3.1826,-4.1206,3
"3175",1,26,8,-18,-28.3841026693721,12.8174,6.8794,8
"3176",1,20,6,-14,-21.741005313265,8.8174,8.8794,2
"3177",1,11,7,-4,-9.77663635897063,-1.1826,7.8794,-7
"3178",1,15,10,-5,-13.0139905951544,-0.1826,4.8794,-3
"3179",1,19,30,11,-6.38344275186878,-16.1826,-15.1206,1
"3180",1,23,0,-23,-29.4540527078498,17.8174,14.8794,5
"3181",1,19,28,9,-7.59517124231779,-14.1826,-13.1206,1
"3182",1,28,29,1,-18.432438588693,-6.1826,-14.1206,10
"3183",1,24,10,-14,-24.7743236046319,8.8174,4.8794,6
"3184",1,14,10,-4,-11.8082044448211,-1.1826,4.8794,-4
"3185",1,19,5,-14,-21.4647983633351,8.8174,9.8794,1
"3186",1,17,8,-9,-16.6408236875511,3.8174,6.8794,-1
"3187",1,18,11,-7,-16.4369764172499,1.8174,3.8794,0
"3188",1,18,5,-13,-20.1100993165298,7.8174,9.8794,0
"3189",1,12,7,-5,-10.765977440615,-0.1826,7.8794,-6
"3190",1,14,5,-9,-14.7116246958831,3.8174,9.8794,-4
"3191",1,24,1,-23,-30.0881663566993,17.8174,13.8794,6
"3192",1,25,30,5,-13.8207738900903,-10.1826,-15.1206,7
"3193",1,25,5,-20,-29.0062918010954,14.8174,9.8794,7
"3194",1,25,6,-19,-28.5104638823563,13.8174,8.8794,7
"3195",1,21,10,-11,-20.5679976555273,5.8174,4.8794,3
"3196",1,16,8,-8,-15.5378836801297,2.8174,6.8794,-2
"3197",1,14,11,-3,-10.8660488908488,-2.1826,3.8794,-4
"3198",1,12,24,12,-0.879589128495092,-17.1826,-9.1206,-6
"3199",1,19,19,0,-12.9148676144987,-5.1826,-4.1206,1
"3200",1,20,24,4,-11.0693564169696,-9.1826,-9.1206,2
"3201",1,23,8,-15,-24.4947082759631,9.8174,6.8794,5
"3202",1,22,16,-6,-18.6882617980077,0.8174,-1.1206,4
"3203",1,14,0,-14,-17.8824926861502,8.8174,14.8794,-4
"3204",1,24,16,-8,-21.0154015730066,2.8174,-1.1206,6
"3205",1,13,9,-4,-11.0871581986242,-1.1826,5.8794,-5
"3206",1,19,27,8,-8.07060081059553,-13.1826,-12.1206,1
"3207",1,19,23,4,-10.3854119230041,-9.1826,-8.1206,1
"3208",1,16,27,11,-4.09092632761783,-16.1826,-12.1206,-2
"3209",1,21,10,-11,-20.7570736214864,5.8174,4.8794,3
"3210",1,22,5,-17,-24.8589247520868,11.8174,9.8794,4
"3211",1,24,4,-20,-28.4590912876381,14.8174,10.8794,6
"3212",1,21,2,-19,-25.5899809544878,13.8174,12.8794,3
"3213",1,19,3,-16,-22.3458162466574,10.8174,11.8794,1
"3214",1,21,27,6,-10.6756903380013,-11.1826,-12.1206,3
"3215",1,19,12,-7,-17.1047226867989,1.8174,2.8794,1
"3216",1,20,21,1,-12.8566153317689,-6.1826,-6.1206,2
"3217",1,23,30,7,-11.4806195928479,-12.1826,-15.1206,5
"3218",1,23,24,1,-14.7938495563643,-6.1826,-9.1206,5
"3219",1,23,24,1,-15.0037794671892,-6.1826,-9.1206,5
"3220",1,21,19,-2,-15.5302542612269,-3.1826,-4.1206,3
"3221",1,22,2,-20,-27.162500513825,14.8174,12.8794,4
"3222",1,24,18,-6,-20.130567872184,0.8174,-3.1206,6
"3223",1,20,6,-14,-21.9892337191199,8.8174,8.8794,2
"3224",1,21,12,-9,-19.6240821499933,3.8174,2.8794,3
"3225",1,27,6,-21,-30.8862308831202,15.8174,8.8794,9
"3226",1,19,12,-7,-17.0569953237133,1.8174,2.8794,1
"3227",1,16,25,9,-5.36198982254032,-14.1826,-10.1206,-2
"3228",1,16,18,2,-9.40913177313674,-7.1826,-3.1206,-2
"3229",1,22,21,-1,-15.3828354088564,-4.1826,-6.1206,4
"3230",1,14,21,7,-5.12268537982814,-12.1826,-6.1206,-4
"3231",1,20,23,3,-12.0229278580135,-8.1826,-8.1206,2
"3232",1,20,25,5,-10.6208757766172,-10.1826,-10.1206,2
"3233",1,23,25,2,-14.4464595533218,-7.1826,-10.1206,5
"3234",1,11,25,14,1.2494320965267,-19.1826,-10.1206,-7
"3235",1,19,12,-7,-17.3526610028336,1.8174,2.8794,1
"3236",1,18,5,-13,-19.7991908712374,7.8174,9.8794,0
"3237",1,11,22,11,-0.40854517353534,-16.1826,-7.1206,-7
"3238",1,24,23,-1,-16.978579169778,-4.1826,-8.1206,6
"3239",1,21,12,-9,-19.6164543032363,3.8174,2.8794,3
"3240",1,28,1,-27,-34.9706860479431,21.8174,13.8794,10
"3241",1,25,10,-15,-26.0927824332487,9.8174,4.8794,7
"3242",1,27,4,-23,-32.2790389986657,17.8174,10.8794,9
"3243",1,14,29,15,-0.298382673801384,-20.1826,-14.1206,-4
"3244",1,15,9,-6,-13.8403318493195,0.8174,5.8794,-3
"3245",1,18,1,-17,-22.5455342512255,11.8174,13.8794,0
"3246",1,24,14,-10,-22.3515408761312,4.8174,0.8794,6
"3247",1,19,1,-18,-23.7634001112631,12.8174,13.8794,1
"3248",1,20,7,-13,-21.446472059823,7.8174,7.8794,2
"3249",1,17,14,-3,-13.1242626581338,-2.1826,0.8794,-1
"3250",1,24,7,-17,-26.4862425973072,11.8174,7.8794,6
"3251",1,19,23,4,-10.158574797615,-9.1826,-8.1206,1
"3252",1,20,11,-9,-19.1507728379755,3.8174,3.8794,2
"3253",1,16,1,-15,-19.6806268649336,9.8174,13.8794,-2
"3254",1,19,20,1,-12.4138038009883,-6.1826,-5.1206,1
"3255",1,27,17,-10,-24.5182055460156,4.8174,-2.1206,9
"3256",1,13,2,-11,-15.1893349179653,5.8174,12.8794,-5
"3257",1,21,5,-16,-23.5687392798631,10.8174,9.8794,3
"3258",1,27,30,3,-16.5428751283279,-8.1826,-15.1206,9
"3259",1,20,29,9,-8.13655820093218,-14.1826,-14.1206,2
"3260",1,15,22,7,-5.52659840803866,-12.1826,-7.1206,-3
"3261",1,25,23,-2,-18.2701179248003,-3.1826,-8.1206,7
"3262",1,25,4,-21,-29.415709051122,15.8174,10.8794,7
"3263",1,13,16,3,-6.77130556621157,-8.1826,-1.1206,-5
"3264",1,14,7,-7,-13.304042803635,1.8174,7.8794,-4
"3265",1,23,16,-7,-19.7267966001493,1.8174,-1.1206,5
"3266",1,22,30,8,-10.3039255349151,-13.1826,-15.1206,4
"3267",1,14,18,4,-7.19168082291063,-9.1826,-3.1206,-4
"3268",1,21,24,3,-12.3903198162135,-8.1826,-9.1206,3
"3269",1,22,19,-3,-16.7913345090716,-2.1826,-4.1206,4
"3270",1,18,18,0,-12.2520420944843,-5.1826,-3.1206,0
"3271",1,26,8,-18,-28.4476618881595,12.8174,6.8794,8
"3272",1,18,13,-5,-15.2000050669964,-0.1826,1.8794,0
"3273",1,21,14,-7,-18.3040921631656,1.8174,0.8794,3
"3274",1,27,3,-24,-32.8089238951506,18.8174,11.8794,9
"3275",1,22,8,-14,-22.9325486216102,8.8174,6.8794,4
"3276",1,17,6,-11,-18.2162617489365,5.8174,8.8794,-1
"3277",1,19,12,-7,-16.9966629873736,1.8174,2.8794,1
"3278",1,16,22,6,-7.01785373034345,-11.1826,-7.1206,-2
"3279",1,14,15,1,-8.8751838290777,-6.1826,-0.1206,-4
"3280",1,25,19,-6,-20.7653850301025,0.8174,-4.1206,7
"3281",1,6,12,6,-0.322363781800891,-11.1826,2.8794,-12
"3282",1,21,27,6,-10.3944861919214,-11.1826,-12.1206,3
"3283",1,23,4,-19,-26.6738636415695,13.8174,10.8794,5
"3284",1,16,28,12,-3.51265645636783,-17.1826,-13.1206,-2
"3285",1,15,9,-6,-13.3049437723743,0.8174,5.8794,-3
"3286",1,20,24,4,-11.0458668608348,-9.1826,-9.1206,2
"3287",1,16,23,7,-6.53998960599873,-12.1826,-8.1206,-2
"3288",1,25,9,-16,-26.5473322628561,10.8174,5.8794,7
"3289",1,11,19,8,-2.19688302587183,-13.1826,-4.1206,-7
"3290",1,23,29,6,-12.1344207105029,-11.1826,-14.1206,5
"3291",1,21,17,-4,-16.72645834677,-1.1826,-2.1206,3
"3292",1,22,29,7,-10.8524599861484,-12.1826,-14.1206,4
"3293",1,21,14,-7,-18.3674024351713,1.8174,0.8794,3
"3294",1,18,7,-11,-18.7584067911141,5.8174,7.8794,0
"3295",1,15,1,-14,-18.5718764489959,8.8174,13.8794,-3
"3296",1,15,23,8,-5.31496794858158,-13.1826,-8.1206,-3
"3297",1,25,30,5,-14.038834377098,-10.1826,-15.1206,7
"3298",1,20,12,-8,-18.3188612938527,2.8174,2.8794,2
"3299",1,16,2,-14,-19.1548573298072,8.8174,12.8794,-2
"3300",1,12,25,13,0.066245723302059,-18.1826,-10.1206,-6
"3301",1,16,22,6,-6.81396154551494,-11.1826,-7.1206,-2
"3302",1,17,29,12,-4.11201215800707,-17.1826,-14.1206,-1
"3303",1,22,30,8,-10.3716150328788,-13.1826,-15.1206,4
"3304",1,25,30,5,-14.0619581442438,-10.1826,-15.1206,7
"3305",1,21,10,-11,-20.935369248796,5.8174,4.8794,3
"3306",1,17,24,7,-6.99908025659395,-12.1826,-9.1206,-1
"3307",1,18,29,11,-5.49839345054879,-16.1826,-14.1206,0
"3308",1,27,25,-2,-19.804657884568,-3.1826,-10.1206,9
"3309",1,29,11,-18,-30.8320248275907,12.8174,3.8794,11
"3310",1,20,0,-20,-25.4486169831377,14.8174,14.8794,2
"3311",1,23,19,-4,-18.0273082508995,-1.1826,-4.1206,5
"3312",1,22,23,1,-14.0285382495967,-6.1826,-8.1206,4
"3313",1,30,29,-1,-21.3378012557477,-4.1826,-14.1206,12
"3314",1,20,13,-7,-17.5758773497257,1.8174,1.8794,2
"3315",1,18,8,-10,-18.0132646906283,4.8174,6.8794,0
"3316",1,15,4,-11,-16.7126640645355,5.8174,10.8794,-3
"3317",1,25,6,-19,-28.4834270794502,13.8174,8.8794,7
"3318",1,31,9,-22,-34.590025649965,16.8174,5.8794,13
"3319",1,21,2,-19,-25.4304122856633,13.8174,12.8794,3
"3320",1,20,24,4,-11.2800364658221,-9.1826,-9.1206,2
"3321",1,25,8,-17,-27.2197310729957,11.8174,6.8794,7
"3322",1,24,5,-19,-27.5067863549726,13.8174,9.8794,6
"3323",1,25,2,-23,-30.6249883282815,17.8174,12.8794,7
"3324",1,22,4,-18,-25.6651684609808,12.8174,10.8794,4
"3325",1,18,4,-14,-20.5398441451004,8.8174,10.8794,0
"3326",1,11,29,18,3.53539714661814,-23.1826,-14.1206,-7
"3327",1,20,4,-16,-23.2691915513315,10.8174,10.8794,2
"3328",1,26,19,-7,-21.5551255809966,1.8174,-4.1206,8
"3329",1,19,11,-8,-17.5656654509576,2.8174,3.8794,1
"3330",1,19,24,5,-9.97337056564149,-10.1826,-9.1206,1
"3331",1,15,1,-14,-18.3768215498868,8.8174,13.8794,-3
"3332",1,19,1,-18,-23.5808223248508,12.8174,13.8794,1
"3333",1,22,3,-19,-26.2666887073486,13.8174,11.8794,4
"3334",1,23,21,-2,-16.7311848212052,-3.1826,-6.1206,5
"3335",1,26,23,-3,-19.3374813442315,-2.1826,-8.1206,8
"3336",1,16,20,4,-8.34135886319948,-9.1826,-5.1206,-2
"3337",1,22,25,3,-13.2511774654864,-8.1826,-10.1206,4
"3338",1,16,20,4,-8.41452601870376,-9.1826,-5.1206,-2
"3339",1,19,21,2,-11.3770243062301,-7.1826,-6.1206,1
"3340",1,14,9,-5,-12.4209289511225,-0.1826,5.8794,-4
"3341",1,15,26,11,-3.3696161653203,-16.1826,-11.1206,-3
"3342",1,18,4,-14,-20.5342523664182,8.8174,10.8794,0
"3343",1,26,13,-13,-25.3884549020447,7.8174,1.8794,8
"3344",1,26,14,-12,-24.9548053272834,6.8174,0.8794,8
"3345",1,22,8,-14,-23.2855408360977,8.8174,6.8794,4
"3346",1,19,24,5,-9.90181880590224,-10.1826,-9.1206,1
"3347",1,28,0,-28,-35.8745128905381,22.8174,14.8794,10
"3348",1,21,29,8,-9.19004265447855,-13.1826,-14.1206,3
"3349",1,14,16,2,-7.87124886329463,-7.1826,-1.1206,-4
"3350",1,21,7,-14,-22.8772222757906,8.8174,7.8794,3
"3351",1,20,0,-20,-25.5078295999954,14.8174,14.8794,2
"3352",1,24,15,-9,-21.6403441127719,3.8174,-0.1206,6
"3353",1,16,26,10,-4.80657481836416,-15.1826,-11.1206,-2
"3354",1,23,23,0,-15.6689608430746,-5.1826,-8.1206,5
"3355",1,23,10,-13,-23.0445089670928,7.8174,4.8794,5
"3356",1,24,5,-19,-27.5886882880996,13.8174,9.8794,6
"3357",1,21,0,-21,-26.9124129073546,15.8174,14.8794,3
"3358",1,17,30,13,-3.43501250901017,-18.1826,-15.1206,-1
"3359",1,24,11,-13,-24.2705582867716,7.8174,3.8794,6
"3360",1,18,21,3,-10.2977555234584,-8.1826,-6.1206,0
"3361",1,22,21,-1,-15.4302276180404,-4.1826,-6.1206,4
"3362",1,17,28,11,-4.62148104027279,-16.1826,-13.1206,-1
"3363",1,24,27,3,-14.5671791494024,-8.1826,-12.1206,6
"3364",1,22,23,1,-14.5146929347945,-6.1826,-8.1206,4
"3365",1,17,4,-13,-19.3803428195895,7.8174,10.8794,-1
"3366",1,19,21,2,-11.984114013098,-7.1826,-6.1206,1
"3367",1,22,16,-6,-18.5051007595574,0.8174,-1.1206,4
"3368",1,16,27,11,-3.9483576087496,-16.1826,-12.1206,-2
"3369",1,18,13,-5,-15.0618733904082,-0.1826,1.8794,0
"3370",1,21,24,3,-12.805207373914,-8.1826,-9.1206,3
"3371",1,22,14,-8,-19.6650961545194,2.8174,0.8794,4
"3372",1,22,26,4,-12.4377023146754,-9.1826,-11.1206,4
"3373",1,25,13,-12,-24.0419998410826,6.8174,1.8794,7
"3374",1,22,19,-3,-16.7605462954787,-2.1826,-4.1206,4
"3375",1,24,11,-13,-24.0098215175113,7.8174,3.8794,6
"3376",1,19,11,-8,-17.3511310090612,2.8174,3.8794,1
"3377",1,21,23,2,-13.1651640171184,-7.1826,-8.1206,3
"3378",1,23,3,-20,-27.6040717989949,14.8174,11.8794,5
"3379",1,28,27,-1,-19.8505286270156,-4.1826,-12.1206,10
"3380",1,24,6,-18,-27.0649802773887,12.8174,8.8794,6
"3381",1,18,25,7,-7.71681245893045,-12.1826,-10.1206,0
"3382",1,16,21,5,-7.64110068483177,-10.1826,-6.1206,-2
"3383",1,13,17,4,-6.10589484370212,-9.1826,-2.1206,-5
"3384",1,27,7,-20,-30.239243835257,14.8174,7.8794,9
"3385",1,26,14,-12,-24.9914357537656,6.8174,0.8794,8
"3386",1,18,27,9,-7.0038899621104,-14.1826,-12.1206,0
"3387",1,19,24,5,-9.7740016489644,-10.1826,-9.1206,1
"3388",1,25,15,-10,-23.0123194019658,4.8174,-0.1206,7
"3389",1,29,5,-24,-34.2836242139412,18.8174,9.8794,11
"3390",1,18,18,0,-12.0010969387476,-5.1826,-3.1206,0
"3391",1,20,28,8,-8.74072186493526,-13.1826,-13.1206,2
"3392",1,18,2,-16,-21.6570017277032,10.8174,12.8794,0
"3393",1,24,24,0,-16.533748308972,-5.1826,-9.1206,6
"3394",1,22,14,-8,-19.7058686239881,2.8174,0.8794,4
"3395",1,18,2,-16,-21.6365295438442,10.8174,12.8794,0
"3396",1,25,4,-21,-29.6972765617136,15.8174,10.8794,7
"3397",1,20,25,5,-10.5945795209769,-10.1826,-10.1206,2
"3398",1,18,24,6,-8.38623754742193,-11.1826,-9.1206,0
"3399",1,22,5,-17,-25.3422800800566,11.8174,9.8794,4
"3400",1,21,26,5,-10.8884754908955,-10.1826,-11.1206,3
"3401",1,28,28,0,-19.0866476297666,-5.1826,-13.1206,10
"3402",1,21,13,-8,-19.0012418694415,2.8174,1.8794,3
"3403",1,19,22,3,-11.1805518459167,-8.1826,-7.1206,1
"3404",1,18,14,-4,-14.3896424327946,-1.1826,0.8794,0
"3405",1,21,18,-3,-16.260212822442,-2.1826,-3.1206,3
"3406",1,16,14,-2,-12.1032885092279,-3.1826,0.8794,-2
"3407",1,16,10,-6,-14.3317122272228,0.8174,4.8794,-2
"3408",1,21,24,3,-12.7524405404545,-8.1826,-9.1206,3
"3409",1,23,22,-1,-15.9810006026892,-4.1826,-7.1206,5
"3410",1,26,3,-23,-31.4280618716922,17.8174,11.8794,8
"3411",1,12,27,15,0.986717420838292,-20.1826,-12.1206,-6
"3412",1,14,1,-13,-17.1634387753397,7.8174,13.8794,-4
"3413",1,18,6,-12,-19.133034474604,6.8174,8.8794,0
"3414",1,20,22,2,-12.3821441577803,-7.1826,-7.1206,2
"3415",1,26,30,4,-15.5187172668435,-9.1826,-15.1206,8
"3416",1,16,8,-8,-15.4008049249593,2.8174,6.8794,-2
"3417",1,13,0,-13,-16.1961462208346,7.8174,14.8794,-5
"3418",1,19,30,11,-6.10698371482876,-16.1826,-15.1206,1
"3419",1,18,1,-17,-22.1766425169108,11.8174,13.8794,0
"3420",1,23,20,-3,-17.3773978235803,-2.1826,-5.1206,5
"3421",1,15,17,2,-8.83221982687081,-7.1826,-2.1206,-3
"3422",1,27,6,-21,-30.7693258928124,15.8174,8.8794,9
"3423",1,13,27,14,-0.362516461541306,-19.1826,-12.1206,-5
"3424",1,22,21,-1,-15.6206780414194,-4.1826,-6.1206,4
"3425",1,25,0,-25,-32.1781120109384,19.8174,14.8794,7
"3426",1,22,5,-17,-25.2261616575189,11.8174,9.8794,4
"3427",1,20,8,-12,-20.7933104194725,6.8174,6.8794,2
"3428",1,27,0,-27,-34.6537213333952,21.8174,14.8794,9
"3429",1,12,3,-9,-13.2447455345934,3.8174,11.8794,-6
"3430",1,26,21,-5,-20.8194704774997,-0.1826,-6.1206,8
"3431",1,25,12,-13,-24.5266748846295,7.8174,2.8794,7
"3432",1,18,14,-4,-14.4021618488961,-1.1826,0.8794,0
"3433",1,21,14,-7,-18.5130071914327,1.8174,0.8794,3
"3434",1,15,30,15,-0.99655505907213,-20.1826,-15.1206,-3
"3435",1,21,28,7,-9.8363297593961,-12.1826,-13.1206,3
"3436",1,21,0,-21,-26.9322821913856,15.8174,14.8794,3
"3437",1,13,18,5,-5.47282208046265,-10.1826,-3.1206,-5
"3438",1,23,29,6,-11.8502174057536,-11.1826,-14.1206,5
"3439",1,20,2,-18,-24.2317637270805,12.8174,12.8794,2
"3440",1,20,7,-13,-21.3370953149506,7.8174,7.8794,2
"3441",1,20,2,-18,-24.2926750043931,12.8174,12.8794,2
"3442",1,26,8,-18,-28.5386802513166,12.8174,6.8794,8
"3443",1,17,23,6,-7.75971780563807,-11.1826,-8.1206,-1
"3444",1,35,27,-8,-28.5242901307375,2.8174,-12.1206,17
"3445",1,24,5,-19,-27.6584854742524,13.8174,9.8794,6
"3446",1,17,5,-12,-19.0217770135147,6.8174,9.8794,-1
"3447",1,18,0,-18,-22.7725044756203,12.8174,14.8794,0
"3448",1,17,1,-16,-20.8395408999666,10.8174,13.8794,-1
"3449",1,31,27,-4,-23.3321101192182,-1.1826,-12.1206,13
"3450",1,19,12,-7,-16.9675015266939,1.8174,2.8794,1
"3451",1,17,0,-17,-21.4796466007136,11.8174,14.8794,-1
"3452",1,17,19,2,-9.97142442396251,-7.1826,-4.1206,-1
"3453",1,13,30,17,1.91772375837986,-22.1826,-15.1206,-5
"3454",1,22,28,6,-11.2364785587914,-11.1826,-13.1206,4
"3455",1,27,13,-14,-27.092810694792,8.8174,1.8794,9
"3456",1,16,12,-4,-12.8146065629048,-1.1826,2.8794,-2
"3457",1,15,2,-13,-17.7014621444389,7.8174,12.8794,-3
"3458",1,16,27,11,-4.24745347652099,-16.1826,-12.1206,-2
"3459",1,21,10,-11,-20.6617910001734,5.8174,4.8794,3
"3460",1,18,26,8,-7.407321812615,-13.1826,-11.1206,0
"3461",1,24,22,-2,-17.7361175116822,-3.1826,-7.1206,6
"3462",1,28,17,-11,-25.4147561105063,5.8174,-2.1206,10
"3463",1,21,20,-1,-14.8570866734109,-4.1826,-5.1206,3
"3464",1,14,8,-6,-12.9446130715177,0.8174,6.8794,-4
"3465",1,18,28,10,-5.87282656910429,-15.1826,-13.1206,0
"3466",1,31,7,-24,-35.7313082537135,18.8174,7.8794,13
"3467",1,16,21,5,-7.68870795730847,-10.1826,-6.1206,-2
"3468",1,13,6,-7,-12.5523527392333,1.8174,8.8794,-5
"3469",1,17,15,-2,-12.593131275629,-3.1826,-0.1206,-1
"3470",1,21,30,9,-8.97350583998071,-14.1826,-15.1206,3
"3471",1,20,19,-1,-14.1665204837259,-4.1826,-4.1206,2
"3472",1,16,27,11,-4.06617853709308,-16.1826,-12.1206,-2
"3473",1,13,14,1,-7.89341030268245,-6.1826,0.8794,-5
"3474",1,17,1,-16,-21.0497512695871,10.8174,13.8794,-1
"3475",1,18,7,-11,-18.6675706622843,5.8174,7.8794,0
"3476",1,18,12,-6,-15.7711313151161,0.8174,2.8794,0
"3477",1,22,23,1,-14.1752797146007,-6.1826,-8.1206,4
"3478",1,22,17,-5,-17.694707100926,-0.1826,-2.1206,4
"3479",1,20,29,9,-8.04152095684729,-14.1826,-14.1206,2
"3480",1,28,3,-25,-34.3369505736618,19.8174,11.8794,10
"3481",1,16,28,12,-3.4248737970619,-17.1826,-13.1206,-2
"3482",1,18,3,-15,-21.287467103886,9.8174,11.8794,0
"3483",1,16,1,-15,-20.0145175945681,9.8174,13.8794,-2
"3484",1,15,6,-9,-15.511334780037,3.8174,8.8794,-3
"3485",1,19,29,10,-6.97413386693956,-15.1826,-14.1206,1
"3486",1,18,16,-2,-13.2773110414721,-3.1826,-1.1206,0
"3487",1,25,12,-13,-24.6447206475461,7.8174,2.8794,7
"3488",1,21,30,9,-8.77367862255518,-14.1826,-15.1206,3
"3489",1,20,0,-20,-25.5380571889847,14.8174,14.8794,2
"3490",1,29,3,-26,-35.7178773384892,20.8174,11.8794,11
"3491",1,26,29,3,-15.6982624386501,-8.1826,-14.1206,8
"3492",1,8,6,-2,-6.32974136951754,-3.1826,8.8794,-10
"3493",1,20,21,1,-12.860259565088,-6.1826,-6.1206,2
"3494",1,23,27,4,-13.2224058426046,-9.1826,-12.1206,5
"3495",1,20,8,-12,-20.3914297861899,6.8174,6.8794,2
"3496",1,19,21,2,-11.5609542448333,-7.1826,-6.1206,1
"3497",1,14,22,8,-4.2595718895423,-13.1826,-7.1206,-4
"3498",1,20,28,8,-8.83456863732192,-13.1826,-13.1206,2
"3499",1,20,25,5,-10.3490626386755,-10.1826,-10.1206,2
"3500",1,15,6,-9,-15.2451531973907,3.8174,8.8794,-3
"3501",1,20,29,9,-7.91201423839151,-14.1826,-14.1206,2
"3502",1,26,2,-24,-32.0294126904103,18.8174,12.8794,8
"3503",1,25,15,-10,-23.1499382019491,4.8174,-0.1206,7
"3504",1,21,25,4,-11.8021644302197,-9.1826,-10.1206,3
"3505",1,14,4,-10,-15.2323996867457,4.8174,10.8794,-4
"3506",1,17,10,-7,-15.5171888251079,1.8174,4.8794,-1
"3507",1,18,3,-15,-20.8557353075995,9.8174,11.8794,0
"3508",1,32,28,-4,-24.2825678438284,-1.1826,-13.1206,14
"3509",1,17,0,-17,-21.5753076823399,11.8174,14.8794,-1
"3510",1,24,10,-14,-24.5154127781173,8.8174,4.8794,6
"3511",1,19,19,0,-12.9808402378941,-5.1826,-4.1206,1
"3512",1,17,21,4,-8.80648638291018,-9.1826,-6.1206,-1
"3513",1,18,6,-12,-19.4008087782292,6.8174,8.8794,0
"3514",1,12,1,-11,-14.4313101820278,5.8174,13.8794,-6
"3515",1,21,18,-3,-15.8948230454447,-2.1826,-3.1206,3
"3516",1,24,25,1,-15.4050305171836,-6.1826,-10.1206,6
"3517",1,19,3,-16,-22.3075875375205,10.8174,11.8794,1
"3518",1,19,0,-19,-24.3599939789563,13.8174,14.8794,1
"3519",1,24,28,4,-13.8787846039218,-9.1826,-13.1206,6
"3520",1,21,1,-20,-26.3902593603097,14.8174,13.8794,3
"3521",1,24,17,-7,-20.5718503070169,1.8174,-2.1206,6
"3522",1,24,30,6,-12.6648742544816,-11.1826,-15.1206,6
"3523",1,21,18,-3,-16.0613969866856,-2.1826,-3.1206,3
"3524",1,20,13,-7,-17.7621630970285,1.8174,1.8794,2
"3525",1,15,5,-10,-15.8940525570257,4.8174,9.8794,-3
"3526",1,21,8,-13,-22.0072151506541,7.8174,6.8794,3
"3527",1,16,30,14,-2.38539167718476,-19.1826,-15.1206,-2
"3528",1,17,9,-8,-16.305590949759,2.8174,5.8794,-1
"3529",1,21,17,-4,-16.6586744900882,-1.1826,-2.1206,3
"3530",1,19,11,-8,-17.5718230835067,2.8174,3.8794,1
"3531",1,18,4,-14,-20.7189338833766,8.8174,10.8794,0
"3532",1,15,25,10,-4.27492005505884,-15.1826,-10.1206,-3
"3533",1,29,14,-15,-28.7346598766131,9.8174,0.8794,11
"3534",1,15,8,-7,-14.3184124922464,1.8174,6.8794,-3
"3535",1,26,30,4,-15.3515278699958,-9.1826,-15.1206,8
"3536",1,21,10,-11,-21.0326144727256,5.8174,4.8794,3
"3537",1,21,22,1,-13.6907893283402,-6.1826,-7.1206,3
"3538",1,22,2,-20,-26.9282687046225,14.8174,12.8794,4
"3539",1,20,13,-7,-17.5151884871425,1.8174,1.8794,2
"3540",1,22,24,2,-13.6695229026955,-7.1826,-9.1206,4
"3541",1,17,0,-17,-21.4783713213252,11.8174,14.8794,-1
"3542",1,25,17,-8,-21.7928306915308,2.8174,-2.1206,7
"3543",1,17,7,-10,-17.337501700115,4.8174,7.8794,-1
"3544",1,20,8,-12,-20.7881371788596,6.8174,6.8794,2
"3545",1,27,9,-18,-29.0071291803333,12.8174,5.8794,9
"3546",1,20,21,1,-12.6555327221154,-6.1826,-6.1206,2
"3547",1,19,24,5,-9.88131335213629,-10.1826,-9.1206,1
"3548",1,21,6,-15,-23.1345453693191,9.8174,8.8794,3
"3549",1,20,4,-16,-23.0803125748954,10.8174,10.8794,2
"3550",1,15,17,2,-8.99025672773828,-7.1826,-2.1206,-3
"3551",1,26,13,-13,-25.4356897305459,7.8174,1.8794,8
"3552",1,26,12,-14,-25.9732010275968,8.8174,2.8794,8
"3553",1,24,28,4,-13.8280947975628,-9.1826,-13.1206,6
"3554",1,13,25,12,-1.52831248659437,-17.1826,-10.1206,-5
"3555",1,13,25,12,-1.30223036763114,-17.1826,-10.1206,-5
"3556",1,22,19,-3,-16.4826453520276,-2.1826,-4.1206,4
"3557",1,18,8,-10,-18.0217354757501,4.8174,6.8794,0
"3558",1,10,30,20,5.62053541173254,-25.1826,-15.1206,-8
"3559",1,22,24,2,-13.8875811604422,-7.1826,-9.1206,4
"3560",1,17,4,-13,-19.222607407777,7.8174,10.8794,-1
"3561",1,11,22,11,-0.502567558767302,-16.1826,-7.1206,-7
"3562",1,20,25,5,-10.3184370967756,-10.1826,-10.1206,2
"3563",1,22,20,-2,-16.1888011131935,-3.1826,-5.1206,4
"3564",1,20,5,-15,-22.3233279268044,9.8174,9.8794,2
"3565",1,25,3,-22,-30.2949247712321,16.8174,11.8794,7
"3566",1,21,14,-7,-18.5663151629592,1.8174,0.8794,3
"3567",1,30,10,-20,-32.3477876006332,14.8174,4.8794,12
"3568",1,19,4,-15,-21.8641377041538,9.8174,10.8794,1
"3569",1,17,19,2,-10.0481331458667,-7.1826,-4.1206,-1
"3570",1,20,13,-7,-17.9544313106033,1.8174,1.8794,2
"3571",1,25,12,-13,-25.1703354270604,7.8174,2.8794,7
"3572",1,19,12,-7,-17.149787787697,1.8174,2.8794,1
"3573",1,24,5,-19,-27.4566551202432,13.8174,9.8794,6
"3574",1,22,5,-17,-25.2946640682486,11.8174,9.8794,4
"3575",1,21,8,-13,-22.0241461719968,7.8174,6.8794,3
"3576",1,21,12,-9,-19.5951069283828,3.8174,2.8794,3
"3577",1,22,18,-4,-17.4806138076883,-1.1826,-3.1206,4
"3578",1,18,9,-9,-17.5663999841462,3.8174,5.8794,0
"3579",1,21,13,-8,-19.0070810930568,2.8174,1.8794,3
"3580",1,21,11,-10,-20.2368906329998,4.8174,3.8794,3
"3581",1,19,22,3,-10.9849004142839,-8.1826,-7.1206,1
"3582",1,18,3,-15,-20.9940275580975,9.8174,11.8794,0
"3583",1,22,1,-21,-27.6783788676242,15.8174,13.8794,4
"3584",1,21,30,9,-8.66981827569529,-14.1826,-15.1206,3
"3585",1,20,2,-18,-24.2489637402923,12.8174,12.8794,2
"3586",1,19,20,1,-12.2124008156046,-6.1826,-5.1206,1
"3587",1,27,21,-6,-21.7732254446445,0.8174,-6.1206,9
"3588",1,24,18,-6,-19.7111309535926,0.8174,-3.1206,6
"3589",1,24,5,-19,-27.581136882203,13.8174,9.8794,6
"3590",1,21,3,-18,-25.0873056599289,12.8174,11.8794,3
"3591",1,16,6,-10,-16.6750342398749,4.8174,8.8794,-2
"3592",1,18,27,9,-6.50671196521013,-14.1826,-12.1206,0
"3593",1,25,10,-15,-25.8781073359871,9.8174,4.8794,7
"3594",1,23,3,-20,-27.5966347695164,14.8174,11.8794,5
"3595",1,18,11,-7,-16.0360518705873,1.8174,3.8794,0
"3596",1,23,1,-22,-28.8585013768254,16.8174,13.8794,5
"3597",1,28,14,-14,-27.7856137013838,8.8174,0.8794,10
"3598",1,19,22,3,-11.0401555465473,-8.1826,-7.1206,1
"3599",1,21,17,-4,-16.4290109609338,-1.1826,-2.1206,3
"3600",1,21,23,2,-13.1549338741018,-7.1826,-8.1206,3
"3601",1,20,1,-19,-25.1296701479846,13.8174,13.8794,2
"3602",1,20,29,9,-7.9075652303871,-14.1826,-14.1206,2
"3603",1,15,22,7,-5.89706100956056,-12.1826,-7.1206,-3
"3604",1,14,22,8,-4.77710573603828,-13.1826,-7.1206,-4
"3605",1,26,0,-26,-33.3928385793719,20.8174,14.8794,8
"3606",1,21,13,-8,-19.0601461979725,2.8174,1.8794,3
"3607",1,21,14,-7,-18.2099785314032,1.8174,0.8794,3
"3608",1,21,5,-16,-23.8930532085371,10.8174,9.8794,3
"3609",1,24,5,-19,-27.6896594621785,13.8174,9.8794,6
"3610",1,17,27,10,-5.27823254083488,-15.1826,-12.1206,-1
"3611",1,26,25,-1,-18.2038392570346,-4.1826,-10.1206,8
"3612",1,19,0,-19,-24.0884158488994,13.8174,14.8794,1
"3613",1,20,0,-20,-25.3346322258775,14.8174,14.8794,2
"3614",1,20,23,3,-11.7272994217562,-8.1826,-8.1206,2
"3615",1,20,22,2,-12.5872362784177,-7.1826,-7.1206,2
"3616",1,17,23,6,-7.84720313297859,-11.1826,-8.1206,-1
"3617",1,24,16,-8,-20.9467607231553,2.8174,-1.1206,6
"3618",1,24,7,-17,-26.1432595292033,11.8174,7.8794,6
"3619",1,20,12,-8,-18.0852981007902,2.8174,2.8794,2
"3620",1,24,29,5,-13.2893753659396,-10.1826,-14.1206,6
"3621",1,12,16,4,-5.68614657506376,-9.1826,-1.1206,-6
"3622",1,22,20,-2,-16.1197656497235,-3.1826,-5.1206,4
"3623",1,22,21,-1,-15.4675391911902,-4.1826,-6.1206,4
"3624",1,21,1,-20,-25.9796741389143,14.8174,13.8794,3
"3625",1,14,18,4,-6.78377483990031,-9.1826,-3.1206,-4
"3626",1,18,8,-10,-18.3572640824053,4.8174,6.8794,0
"3627",1,24,4,-20,-28.0457011376951,14.8174,10.8794,6
"3628",1,16,26,10,-4.58137220586394,-15.1826,-11.1206,-2
"3629",1,36,30,-6,-28.198658697565,0.8174,-15.1206,18
"3630",1,15,22,7,-5.82693958430185,-12.1826,-7.1206,-3
"3631",1,30,21,-9,-25.9225018917427,3.8174,-6.1206,12
"3632",1,20,16,-4,-15.9221979834023,-1.1826,-1.1206,2
"3633",1,16,14,-2,-11.8954005807896,-3.1826,0.8794,-2
"3634",1,21,15,-6,-17.7716862078232,0.8174,-0.1206,3
"3635",1,28,10,-18,-29.7677453282246,12.8174,4.8794,10
"3636",1,30,5,-25,-35.404110394774,19.8174,9.8794,12
"3637",1,18,10,-8,-16.959941669096,2.8174,4.8794,0
"3638",1,27,13,-14,-27.0581610369421,8.8174,1.8794,9
"3639",1,19,29,10,-6.79239394710925,-15.1826,-14.1206,1
"3640",1,26,4,-22,-31.0315505917672,16.8174,10.8794,8
"3641",1,19,26,7,-8.85454973428403,-12.1826,-11.1206,1
"3642",1,19,22,3,-10.9134423970107,-8.1826,-7.1206,1
"3643",1,25,27,2,-15.9807784818335,-7.1826,-12.1206,7
"3644",1,13,30,17,1.24972600570481,-22.1826,-15.1206,-5
"3645",1,17,24,7,-7.42833042952685,-12.1826,-9.1206,-1
"3646",1,20,14,-6,-17.0240114764861,0.8174,0.8794,2
"3647",1,14,28,14,-0.838594883519166,-19.1826,-13.1206,-4
"3648",1,13,8,-5,-11.6082237183044,-0.1826,6.8794,-5
"3649",1,21,0,-21,-26.9723231158372,15.8174,14.8794,3
"3650",1,20,8,-12,-20.8804861215922,6.8174,6.8794,2
"3651",1,16,13,-3,-12.4681868964695,-2.1826,1.8794,-2
"3652",1,17,16,-1,-12.1254484802223,-4.1826,-1.1206,-1
"3653",1,25,8,-17,-27.006110824296,11.8174,6.8794,7
"3654",1,15,6,-9,-15.2795941460231,3.8174,8.8794,-3
"3655",1,26,7,-19,-28.8771577379631,13.8174,7.8794,8
"3656",1,15,23,8,-5.26418314414313,-13.1826,-8.1206,-3
"3657",1,27,25,-2,-19.5264859148494,-3.1826,-10.1206,9
"3658",1,16,29,13,-2.93288176556729,-18.1826,-14.1206,-2
"3659",1,16,9,-7,-15.0774018454851,1.8174,5.8794,-2
"3660",1,24,23,-1,-16.7470558324912,-4.1826,-8.1206,6
"3661",1,23,19,-4,-18.0171459127287,-1.1826,-4.1206,5
"3662",1,21,15,-6,-17.946711916647,0.8174,-0.1206,3
"3663",1,17,3,-14,-20.0389656789628,8.8174,11.8794,-1
"3664",1,19,10,-9,-18.2039574924414,3.8174,4.8794,1
"3665",1,18,12,-6,-15.7270581367393,0.8174,2.8794,0
"3666",1,18,14,-4,-14.6109535283056,-1.1826,0.8794,0
"3667",1,21,0,-21,-26.7473813499832,15.8174,14.8794,3
"3668",1,16,13,-3,-12.345315618298,-2.1826,1.8794,-2
"3669",1,24,17,-7,-20.7485784352328,1.8174,-2.1206,6
"3670",1,20,17,-3,-15.3925693235879,-2.1826,-2.1206,2
"3671",1,19,30,11,-6.42723568039307,-16.1826,-15.1206,1
"3672",1,16,26,10,-4.93208663292433,-15.1826,-11.1206,-2
"3673",1,26,0,-26,-33.2576839364725,20.8174,14.8794,8
"3674",1,19,9,-10,-18.7463846246375,4.8174,5.8794,1
"3675",1,14,3,-11,-16.0614656665971,5.8174,11.8794,-4
"3676",1,20,16,-4,-15.8443496553288,-1.1826,-1.1206,2
"3677",1,14,30,16,0.35372292032613,-21.1826,-15.1206,-4
"3678",1,21,11,-10,-20.1888075274187,4.8174,3.8794,3
"3679",1,23,7,-16,-25.2451754130338,10.8174,7.8794,5
"3680",1,16,27,11,-4.09468378364886,-16.1826,-12.1206,-2
"3681",1,19,5,-14,-21.2237978506059,8.8174,9.8794,1
"3682",1,22,21,-1,-15.7150270441121,-4.1826,-6.1206,4
"3683",1,11,7,-4,-9.54353159418861,-1.1826,7.8794,-7
"3684",1,19,25,6,-8.94891279386932,-11.1826,-10.1206,1
"3685",1,12,16,4,-5.59941790796928,-9.1826,-1.1206,-6
"3686",1,21,14,-7,-18.4880232096514,1.8174,0.8794,3
"3687",1,22,18,-4,-17.137316050662,-1.1826,-3.1206,4
"3688",1,17,3,-14,-19.6275095556204,8.8174,11.8794,-1
"3689",1,20,1,-19,-24.6183189878547,13.8174,13.8794,2
"3690",1,23,3,-20,-27.2333517277959,14.8174,11.8794,5
"3691",1,22,19,-3,-16.5550140476477,-2.1826,-4.1206,4
"3692",1,25,8,-17,-27.1490338799441,11.8174,6.8794,7
"3693",1,25,11,-14,-25.4197225557022,8.8174,3.8794,7
"3694",1,16,14,-2,-11.7505058908321,-3.1826,0.8794,-2
"3695",1,25,24,-1,-17.3065671740707,-4.1826,-9.1206,7
"3696",1,23,26,3,-13.5285547481846,-8.1826,-11.1206,5
"3697",1,15,9,-6,-13.4791536724287,0.8174,5.8794,-3
"3698",1,14,25,11,-2.75522822751549,-16.1826,-10.1206,-4
"3699",1,14,11,-3,-11.1477207150041,-2.1826,3.8794,-4
"3700",1,15,10,-5,-13.0881861638632,-0.1826,4.8794,-3
"3701",1,15,10,-5,-12.9069882271482,-0.1826,4.8794,-3
"3702",1,25,15,-10,-23.1060072932425,4.8174,-0.1206,7
"3703",1,17,30,13,-3.5718316976094,-18.1826,-15.1206,-1
"3704",1,20,2,-18,-24.1460924090897,12.8174,12.8794,2
"3705",1,28,21,-7,-23.3948915996541,1.8174,-6.1206,10
"3706",1,14,16,2,-8.17778101249018,-7.1826,-1.1206,-4
"3707",1,22,2,-20,-26.7011399062872,14.8174,12.8794,4
"3708",1,18,9,-9,-17.3536286600789,3.8174,5.8794,0
"3709",1,27,5,-22,-31.4651941554232,16.8174,9.8794,9
"3710",1,19,8,-11,-19.5975815818902,5.8174,6.8794,1
"3711",1,27,6,-21,-30.9327357980546,15.8174,8.8794,9
"3712",1,17,23,6,-7.65537517964971,-11.1826,-8.1206,-1
"3713",1,28,21,-7,-22.9123959938756,1.8174,-6.1206,10
"3714",1,15,20,5,-6.90920355999604,-10.1826,-5.1206,-3
"3715",1,18,21,3,-10.1084067887023,-8.1826,-6.1206,0
"3716",1,30,6,-24,-34.9978067600905,18.8174,8.8794,12
"3717",1,23,1,-22,-28.7825840578992,16.8174,13.8794,5
"3718",1,15,13,-2,-11.1441416204685,-3.1826,1.8794,-3
"3719",1,34,10,-24,-38.0050004409765,18.8174,4.8794,16
"3720",1,16,28,12,-3.5277318686455,-17.1826,-13.1206,-2
"3721",1,20,27,7,-9.26398369456335,-12.1826,-12.1206,2
"3722",1,21,4,-17,-24.4923357878941,11.8174,10.8794,3
"3723",1,19,19,0,-12.8624953931849,-5.1826,-4.1206,1
"3724",1,20,13,-7,-17.7270496017348,1.8174,1.8794,2
"3725",1,12,10,-2,-9.09844231695387,-3.1826,4.8794,-6
"3726",1,25,14,-11,-23.4905261873787,5.8174,0.8794,7
"3727",1,19,22,3,-10.9326817790646,-8.1826,-7.1206,1
"3728",1,32,8,-24,-36.2642762732029,18.8174,6.8794,14
"3729",1,24,28,4,-14.0282394436633,-9.1826,-13.1206,6
"3730",1,13,10,-3,-10.3413790685141,-2.1826,4.8794,-5
"3731",1,23,6,-17,-25.7920314017324,11.8174,8.8794,5
"3732",1,23,4,-19,-26.8394354449787,13.8174,10.8794,5
"3733",1,18,25,7,-7.91157743370241,-12.1826,-10.1206,0
"3734",1,14,11,-3,-11.106188954583,-2.1826,3.8794,-4
"3735",1,20,30,10,-7.30864972483823,-15.1826,-15.1206,2
"3736",1,16,27,11,-4.29538370068258,-16.1826,-12.1206,-2
"3737",1,31,24,-7,-25.439046391822,1.8174,-9.1206,13
"3738",1,23,11,-12,-22.8803194778495,6.8174,3.8794,5
"3739",1,8,12,4,-2.68580734166146,-9.1826,2.8794,-10
"3740",1,16,0,-16,-20.4360700036895,10.8174,14.8794,-2
"3741",1,14,13,-1,-9.70000969109985,-4.1826,1.8794,-4
"3742",1,26,23,-3,-19.6872297567819,-2.1826,-8.1206,8
"3743",1,20,11,-9,-19.18963485108,3.8174,3.8794,2
"3744",1,18,4,-14,-20.5426689951247,8.8174,10.8794,0
"3745",1,18,2,-16,-21.792323324778,10.8174,12.8794,0
"3746",1,25,19,-6,-20.6343660670833,0.8174,-4.1206,7
"3747",1,29,16,-13,-27.6070454095741,7.8174,-1.1206,11
"3748",1,19,10,-9,-18.1312729790701,3.8174,4.8794,1
"3749",1,16,16,0,-10.6778013108395,-5.1826,-1.1206,-2
"3750",1,7,25,18,6.45965755960121,-23.1826,-10.1206,-11
"3751",1,17,1,-16,-20.8386613946394,10.8174,13.8794,-1
"3752",1,11,16,5,-4.15608070087156,-10.1826,-1.1206,-7
"3753",1,19,20,1,-12.2874990236357,-6.1826,-5.1206,1
"3754",1,21,23,2,-13.167935848803,-7.1826,-8.1206,3
"3755",1,23,7,-16,-25.2309796060581,10.8174,7.8794,5
"3756",1,17,19,2,-10.2267219153248,-7.1826,-4.1206,-1
"3757",1,23,25,2,-14.5066929929018,-7.1826,-10.1206,5
"3758",1,13,27,14,-0.0535797329805364,-19.1826,-12.1206,-5
"3759",1,25,6,-19,-28.4112854715219,13.8174,8.8794,7
"3760",1,24,19,-5,-19.4697450833051,-0.1826,-4.1206,6
"3761",1,30,22,-8,-25.20928624787,2.8174,-7.1206,12
"3762",1,20,16,-4,-15.9327483479535,-1.1826,-1.1206,2
"3763",1,17,22,5,-8.49751865843189,-10.1826,-7.1206,-1
"3764",1,22,11,-11,-21.4193269023018,5.8174,3.8794,4
"3765",1,18,18,0,-12.1605494222663,-5.1826,-3.1206,0
"3766",1,24,4,-20,-27.9438052593027,14.8174,10.8794,6
"3767",1,22,13,-9,-20.5590740536998,3.8174,1.8794,4
"3768",1,23,15,-8,-20.5340859006237,2.8174,-0.1206,5
"3769",1,21,29,8,-9.37508456022745,-13.1826,-14.1206,3
"3770",1,26,28,2,-16.5439868779549,-7.1826,-13.1206,8
"3771",1,18,23,5,-9.09400565009592,-10.1826,-8.1206,0
"3772",1,19,14,-5,-15.5043261284807,-0.1826,0.8794,1
"3773",1,20,29,9,-8.07938602511332,-14.1826,-14.1206,2
"3774",1,26,10,-16,-27.1741472560655,10.8174,4.8794,8
"3775",1,21,6,-15,-23.1378276393977,9.8174,8.8794,3
"3776",1,22,24,2,-13.4955092142167,-7.1826,-9.1206,4
"3777",1,24,19,-5,-19.2906705107287,-0.1826,-4.1206,6
"3778",1,15,13,-2,-11.169547430381,-3.1826,1.8794,-3
"3779",1,23,13,-10,-21.7933053425684,4.8174,1.8794,5
"3780",1,19,13,-6,-16.4252952474615,0.8174,1.8794,1
"3781",1,27,28,1,-17.6815176133592,-6.1826,-13.1206,9
"3782",1,30,14,-16,-29.8964988179741,10.8174,0.8794,12
"3783",1,20,3,-17,-23.6509709942464,11.8174,11.8794,2
"3784",1,14,18,4,-6.7275119106739,-9.1826,-3.1206,-4
"3785",1,13,26,13,-0.541862721132935,-18.1826,-11.1206,-5
"3786",1,24,14,-10,-22.3792361127123,4.8174,0.8794,6
"3787",1,13,20,7,-4.51707223317809,-12.1826,-5.1206,-5
"3788",1,23,13,-10,-21.6455034416169,4.8174,1.8794,5
"3789",1,20,23,3,-11.6744420354912,-8.1826,-8.1206,2
"3790",1,18,12,-6,-15.5297880914992,0.8174,2.8794,0
"3791",1,24,22,-2,-17.644544493579,-3.1826,-7.1206,6
"3792",1,25,14,-11,-23.443780412233,5.8174,0.8794,7
"3793",1,21,2,-19,-25.7430798483129,13.8174,12.8794,3
"3794",1,27,12,-15,-27.4377283888356,9.8174,2.8794,9
"3795",1,20,16,-4,-15.8691134800935,-1.1826,-1.1206,2
"3796",1,15,5,-10,-15.9261081235881,4.8174,9.8794,-3
"3797",1,22,21,-1,-15.5909779530717,-4.1826,-6.1206,4
"3798",1,19,14,-5,-15.9480542701699,-0.1826,0.8794,1
"3799",1,28,17,-11,-25.7883190592068,5.8174,-2.1206,10
"3800",1,18,2,-16,-21.7553818965947,10.8174,12.8794,0
"3801",1,19,5,-14,-21.205361509234,8.8174,9.8794,1
"3802",1,18,10,-8,-16.9424294220971,2.8174,4.8794,0
"3803",1,20,6,-14,-21.9468408948888,8.8174,8.8794,2
"3804",1,14,0,-14,-17.4004588774158,8.8174,14.8794,-4
"3805",1,22,21,-1,-15.436122303404,-4.1826,-6.1206,4
"3806",1,17,11,-6,-15.1120161059246,0.8174,3.8794,-1
"3807",1,20,15,-5,-16.3890064865996,-0.1826,-0.1206,2
"3808",1,18,28,10,-6.28015576307472,-15.1826,-13.1206,0
"3809",1,24,12,-12,-23.4142896069668,6.8174,2.8794,6
"3810",1,17,1,-16,-21.2921955787996,10.8174,13.8794,-1
"3811",1,27,1,-26,-33.974794054797,20.8174,13.8794,9
"3812",1,27,25,-2,-19.6267283820453,-3.1826,-10.1206,9
"3813",1,17,18,1,-10.8525358496997,-6.1826,-3.1206,-1
"3814",1,22,23,1,-14.4559488192555,-6.1826,-8.1206,4
"3815",1,29,18,-11,-26.2958669944506,5.8174,-3.1206,11
"3816",1,17,7,-10,-17.2031842823346,4.8174,7.8794,-1
"3817",1,20,23,3,-11.4312658849596,-8.1826,-8.1206,2
"3818",1,26,24,-2,-19.307595252173,-3.1826,-9.1206,8
"3819",1,22,27,5,-11.9024105092491,-10.1826,-12.1206,4
"3820",1,22,21,-1,-15.2127591436468,-4.1826,-6.1206,4
"3821",1,18,25,7,-7.75115001677727,-12.1826,-10.1206,0
"3822",1,19,5,-14,-21.2634861622142,8.8174,9.8794,1
"3823",1,16,27,11,-4.16011696371436,-16.1826,-12.1206,-2
"3824",1,26,22,-4,-20.1632595531095,-1.1826,-7.1206,8
"3825",1,25,22,-3,-18.8827178495612,-2.1826,-7.1206,7
"3826",1,25,7,-18,-27.931638705925,12.8174,7.8794,7
"3827",1,25,25,0,-17.2025361053528,-5.1826,-10.1206,7
"3828",1,20,24,4,-11.0477561360741,-9.1826,-9.1206,2
"3829",1,20,29,9,-8.14571982113138,-14.1826,-14.1206,2
"3830",1,28,23,-5,-22.4422711096447,-0.1826,-8.1206,10
"3831",1,20,19,-1,-14.2387635477523,-4.1826,-4.1206,2
"3832",1,32,3,-29,-39.2426712792362,23.8174,11.8794,14
"3833",1,21,0,-21,-26.7764981136801,15.8174,14.8794,3
"3834",1,17,5,-12,-18.699786579522,6.8174,9.8794,-1
"3835",1,25,15,-10,-22.986747861864,4.8174,-0.1206,7
"3836",1,24,4,-20,-28.3201181596922,14.8174,10.8794,6
"3837",1,19,1,-18,-23.3967785234321,12.8174,13.8794,1
"3838",1,19,15,-4,-15.2703491146043,-1.1826,-0.1206,1
"3839",1,13,22,9,-3.2128055015692,-14.1826,-7.1206,-5
"3840",1,17,12,-5,-14.2489070470512,-0.1826,2.8794,-1
"3841",1,16,2,-14,-19.0871461486177,8.8174,12.8794,-2
"3842",1,22,20,-2,-16.1480836516658,-3.1826,-5.1206,4
"3843",1,25,6,-19,-28.4801817069337,13.8174,8.8794,7
"3844",1,24,14,-10,-22.4688887824182,4.8174,0.8794,6
"3845",1,18,10,-8,-16.9992102019551,2.8174,4.8794,0
"3846",1,26,11,-15,-26.8683635228624,9.8174,3.8794,8
"3847",1,24,26,2,-15.1638430936328,-7.1826,-11.1206,6
"3848",1,23,29,6,-12.0945530523843,-11.1826,-14.1206,5
"3849",1,25,3,-22,-30.3711955371248,16.8174,11.8794,7
"3850",1,16,9,-7,-14.9640698320006,1.8174,5.8794,-2
"3851",1,25,13,-12,-24.288229019512,6.8174,1.8794,7
"3852",1,28,15,-13,-26.801630367371,7.8174,-0.1206,10
"3853",1,28,13,-15,-27.9378536556115,9.8174,1.8794,10
"3854",1,18,4,-14,-20.3148501384704,8.8174,10.8794,0
"3855",1,22,14,-8,-19.8597909715869,2.8174,0.8794,4
"3856",1,19,14,-5,-16.1492170960859,-0.1826,0.8794,1
"3857",1,24,18,-6,-20.008232542393,0.8174,-3.1206,6
"3858",1,14,15,1,-8.74132091972151,-6.1826,-0.1206,-4
"3859",1,21,30,9,-8.64421321418192,-14.1826,-15.1206,3
"3860",1,21,23,2,-13.1351548219432,-7.1826,-8.1206,3
"3861",1,15,11,-4,-12.3207356357404,-1.1826,3.8794,-3
"3862",1,18,23,5,-9.04794038253448,-10.1826,-8.1206,0
"3863",1,15,18,3,-8.32184557613664,-8.1826,-3.1206,-3
"3864",1,19,20,1,-12.2061241400763,-6.1826,-5.1206,1
"3865",1,19,18,-1,-13.3384543899563,-4.1826,-3.1206,1
"3866",1,16,2,-14,-18.9378245925575,8.8174,12.8794,-2
"3867",1,18,8,-10,-17.711030293727,4.8174,6.8794,0
"3868",1,18,20,2,-10.8807075622273,-7.1826,-5.1206,0
"3869",1,27,16,-11,-24.9019491788096,5.8174,-1.1206,9
"3870",1,24,24,0,-16.2402903845719,-5.1826,-9.1206,6
"3871",1,21,25,4,-11.8604210592449,-9.1826,-10.1206,3
"3872",1,18,22,4,-9.41135373134602,-9.1826,-7.1206,0
"3873",1,21,4,-17,-24.5681601642077,11.8174,10.8794,3
"3874",1,18,19,1,-11.4096983045759,-6.1826,-4.1206,0
"3875",1,18,30,12,-4.63770304412921,-17.1826,-15.1206,0
"3876",1,20,17,-3,-15.3859842664975,-2.1826,-2.1206,2
"3877",1,18,0,-18,-22.8292611491024,12.8174,14.8794,0
"3878",1,22,30,8,-10.2884920717614,-13.1826,-15.1206,4
"3879",1,21,30,9,-8.8799217087301,-14.1826,-15.1206,3
"3880",1,15,7,-8,-14.9048580218993,2.8174,7.8794,-3
"3881",1,23,8,-15,-24.5554694170706,9.8174,6.8794,5
"3882",1,16,20,4,-8.07516509965091,-9.1826,-5.1206,-2
"3883",1,19,21,2,-11.6695786757725,-7.1826,-6.1206,1
"3884",1,17,13,-4,-13.7223329073101,-1.1826,1.8794,-1
"3885",1,14,3,-11,-15.9835044552227,5.8174,11.8794,-4
"3886",1,22,11,-11,-21.5024262126929,5.8174,3.8794,4
"3887",1,16,18,2,-9.47309784023304,-7.1826,-3.1206,-2
"3888",1,18,11,-7,-16.0690559386802,1.8174,3.8794,0
"3889",1,16,13,-3,-12.7423778526961,-2.1826,1.8794,-2
"3890",1,21,11,-10,-20.3754590288284,4.8174,3.8794,3
"3891",1,23,4,-19,-27.1050426626142,13.8174,10.8794,5
"3892",1,13,24,11,-2.28958619009175,-16.1826,-9.1206,-5
"3893",1,17,25,8,-6.86595836673621,-13.1826,-10.1206,-1
"3894",1,21,27,6,-10.480352040393,-11.1826,-12.1206,3
"3895",1,16,7,-9,-16.4027120588377,3.8174,7.8794,-2
"3896",1,12,0,-12,-14.7942901757929,6.8174,14.8794,-6
"3897",1,17,27,10,-5.39549432978072,-15.1826,-12.1206,-1
"3898",1,19,20,1,-12.1785081413573,-6.1826,-5.1206,1
"3899",1,28,6,-22,-32.3425669633126,16.8174,8.8794,10
"3900",1,24,6,-18,-26.9512316143847,12.8174,8.8794,6
"3901",1,26,22,-4,-20.0063320760626,-1.1826,-7.1206,8
"3902",1,22,6,-16,-24.6327709978824,10.8174,8.8794,4
"3903",1,27,20,-7,-22.4719209123399,1.8174,-5.1206,9
"3904",1,21,30,9,-8.67985400832957,-14.1826,-15.1206,3
"3905",1,26,18,-8,-22.5582483646597,2.8174,-3.1206,8
"3906",1,20,9,-11,-20.3303414450214,5.8174,5.8794,2
"3907",1,17,17,0,-11.4507714036643,-5.1826,-2.1206,-1
"3908",1,19,3,-16,-22.5068988229978,10.8174,11.8794,1
"3909",1,26,17,-9,-23.1384777770239,3.8174,-2.1206,8
"3910",1,27,9,-18,-29.1331670841674,12.8174,5.8794,9
"3911",1,16,9,-7,-14.8997513460709,1.8174,5.8794,-2
"3912",1,20,0,-20,-25.4273183417526,14.8174,14.8794,2
"3913",1,21,21,0,-14.0765209004573,-5.1826,-6.1206,3
"3914",1,19,26,7,-8.66873754546965,-12.1826,-11.1206,1
"3915",1,11,28,17,2.8580478075138,-22.1826,-13.1206,-7
"3916",1,24,22,-2,-17.4037298398041,-3.1826,-7.1206,6
"3917",1,20,18,-2,-14.6535022816758,-3.1826,-3.1206,2
"3918",1,20,19,-1,-14.2413394183038,-4.1826,-4.1206,2
"3919",1,27,3,-24,-32.8886918385469,18.8174,11.8794,9
"3920",1,19,10,-9,-18.3709839367829,3.8174,4.8794,1
"3921",1,15,26,11,-3.51543893199656,-16.1826,-11.1206,-3
"3922",1,20,16,-4,-15.8058132957053,-1.1826,-1.1206,2
"3923",1,19,10,-9,-18.1413107970033,3.8174,4.8794,1
"3924",1,24,30,6,-12.6218623699894,-11.1826,-15.1206,6
"3925",1,25,13,-12,-24.3817192971699,6.8174,1.8794,7
"3926",1,15,8,-7,-14.2478798651958,1.8174,6.8794,-3
"3927",1,15,20,5,-6.91388326549199,-10.1826,-5.1206,-3
"3928",1,20,26,6,-9.81580682102547,-11.1826,-11.1206,2
"3929",1,19,26,7,-8.47266769500078,-12.1826,-11.1206,1
"3930",1,20,1,-19,-25.1114054391442,13.8174,13.8794,2
"3931",1,19,3,-16,-22.4433072240927,10.8174,11.8794,1
"3932",1,18,28,10,-6.10639765241409,-15.1826,-13.1206,0
"3933",1,28,19,-9,-24.5045693085759,3.8174,-4.1206,10
"3934",1,18,21,3,-10.3219254701156,-8.1826,-6.1206,0
"3935",1,15,5,-10,-15.764952257895,4.8174,9.8794,-3
"3936",1,27,24,-3,-19.9942966550154,-2.1826,-9.1206,9
"3937",1,14,18,4,-6.91184446125537,-9.1826,-3.1206,-4
"3938",1,18,6,-12,-19.3151856907834,6.8174,8.8794,0
"3939",1,14,15,1,-8.85041152298939,-6.1826,-0.1206,-4
"3940",1,14,27,13,-1.72726579942638,-18.1826,-12.1206,-4
"3941",1,13,4,-9,-13.9423835351297,3.8174,10.8794,-5
"3942",1,22,5,-17,-25.1014107210752,11.8174,9.8794,4
"3943",1,23,9,-14,-24.0639638048183,8.8174,5.8794,5
"3944",1,15,24,9,-4.4809313921504,-14.1826,-9.1206,-3
"3945",1,27,25,-2,-19.3546330513635,-3.1826,-10.1206,9
"3946",1,26,16,-10,-23.7933287659516,4.8174,-1.1206,8
"3947",1,35,4,-31,-42.5373561747121,25.8174,10.8794,17
"3948",1,23,24,1,-15.0673582542902,-6.1826,-9.1206,5
"3949",1,18,1,-17,-22.1258670082437,11.8174,13.8794,0
"3950",1,26,11,-15,-26.7264875921369,9.8174,3.8794,8
"3951",1,23,12,-11,-22.1016504393922,5.8174,2.8794,5
"3952",1,19,14,-5,-15.9473241375582,-0.1826,0.8794,1
"3953",1,22,18,-4,-17.3996851449693,-1.1826,-3.1206,4
"3954",1,23,12,-11,-22.5865548395751,5.8174,2.8794,5
"3955",1,19,25,6,-9.0973259257825,-11.1826,-10.1206,1
"3956",1,16,4,-12,-17.6965344124735,6.8174,10.8794,-2
"3957",1,18,19,1,-11.538633471712,-6.1826,-4.1206,0
"3958",1,16,13,-3,-12.2336954555755,-2.1826,1.8794,-2
"3959",1,21,25,4,-11.7852118095558,-9.1826,-10.1206,3
"3960",1,9,3,-6,-9.40596455896132,0.8174,11.8794,-9
"3961",1,18,2,-16,-21.9879738278203,10.8174,12.8794,0
"3962",1,17,28,11,-4.50560699646431,-16.1826,-13.1206,-1
"3963",1,17,0,-17,-21.4871676193602,11.8174,14.8794,-1
"3964",1,19,10,-9,-18.0372944241914,3.8174,4.8794,1
"3965",1,9,23,14,2.63403970681394,-19.1826,-8.1206,-9
"3966",1,17,1,-16,-21.1569314016571,10.8174,13.8794,-1
"3967",1,21,14,-7,-18.4143855410865,1.8174,0.8794,3
"3968",1,19,4,-15,-21.9199888688748,9.8174,10.8794,1
"3969",1,17,5,-12,-18.6350903187801,6.8174,9.8794,-1
"3970",1,31,1,-30,-39.4251732004881,24.8174,13.8794,13
"3971",1,23,13,-10,-21.7407191316278,4.8174,1.8794,5
"3972",1,19,27,8,-8.17677885393521,-13.1826,-12.1206,1
"3973",1,23,20,-3,-17.2253426195901,-2.1826,-5.1206,5
"3974",1,16,21,5,-7.71325714437056,-10.1826,-6.1206,-2
"3975",1,25,9,-16,-26.332303273877,10.8174,5.8794,7
"3976",1,10,10,0,-6.12348633088536,-5.1826,4.8794,-8
"3977",1,20,24,4,-11.2288082135336,-9.1826,-9.1206,2
"3978",1,21,30,9,-9.01242846649792,-14.1826,-15.1206,3
"3979",1,19,4,-15,-21.976536445017,9.8174,10.8794,1
"3980",1,17,10,-7,-15.8354314388268,1.8174,4.8794,-1
"3981",1,16,20,4,-8.12783021411093,-9.1826,-5.1206,-2
"3982",1,22,7,-15,-23.8143673726469,9.8174,7.8794,4
"3983",1,13,21,8,-3.77892736496192,-13.1826,-6.1206,-5
"3984",1,17,26,9,-6.04845315881338,-14.1826,-11.1206,-1
"3985",1,22,7,-15,-24.123234063037,9.8174,7.8794,4
"3986",1,19,2,-17,-23.0579642795864,11.8174,12.8794,1
"3987",1,16,0,-16,-20.3194091091093,10.8174,14.8794,-2
"3988",1,14,13,-1,-9.65427918134051,-4.1826,1.8794,-4
"3989",1,27,22,-5,-21.4485285995356,-0.1826,-7.1206,9
"3990",1,28,24,-4,-21.5733645148497,-1.1826,-9.1206,10
"3991",1,21,23,2,-13.1440670056912,-7.1826,-8.1206,3
"3992",1,17,17,0,-11.3577711333788,-5.1826,-2.1206,-1
"3993",1,23,22,-1,-16.1219089420484,-4.1826,-7.1206,5
"3994",1,18,3,-15,-20.9555029390356,9.8174,11.8794,0
"3995",1,21,8,-13,-21.8812944555663,7.8174,6.8794,3
"3996",1,15,0,-15,-19.1837453224513,9.8174,14.8794,-3
"3997",1,24,26,2,-15.2373869561224,-7.1826,-11.1206,6
"3998",1,18,21,3,-10.1952723007492,-8.1826,-6.1206,0
"3999",1,20,4,-16,-23.1683517879985,10.8174,10.8794,2
"4000",1,24,22,-2,-17.7348899695177,-3.1826,-7.1206,6
"4001",1,13,14,1,-8.15114218404299,-6.1826,0.8794,-5
"4002",1,13,27,14,-0.141636531155208,-19.1826,-12.1206,-5
"4003",1,26,26,0,-17.741876765191,-5.1826,-11.1206,8
"4004",1,13,10,-3,-10.6570876156201,-2.1826,4.8794,-5
"4005",1,17,22,5,-8.3122778917701,-10.1826,-7.1206,-1
"4006",1,21,22,1,-13.6148147715461,-6.1826,-7.1206,3
"4007",1,18,20,2,-10.6070280473438,-7.1826,-5.1206,0
"4008",1,18,26,8,-7.38357616162414,-13.1826,-11.1206,0
"4009",1,16,12,-4,-13.0257754152423,-1.1826,2.8794,-2
"4010",1,19,1,-18,-23.6148891047315,12.8174,13.8794,1
"4011",1,17,26,9,-5.87996915056169,-14.1826,-11.1206,-1
"4012",1,22,11,-11,-21.4965578991062,5.8174,3.8794,4
"4013",1,19,22,3,-10.8120966855287,-8.1826,-7.1206,1
"4014",1,23,21,-2,-16.7907745339037,-3.1826,-6.1206,5
"4015",1,18,7,-11,-18.7822952662201,5.8174,7.8794,0
"4016",1,17,15,-2,-12.2916685460216,-3.1826,-0.1206,-1
"4017",1,22,27,5,-11.8986559172329,-10.1826,-12.1206,4
"4018",1,25,13,-12,-24.124722308216,6.8174,1.8794,7
"4019",1,17,13,-4,-13.6984685097057,-1.1826,1.8794,-1
"4020",1,21,4,-17,-24.3669278730963,11.8174,10.8794,3
"4021",1,22,1,-21,-27.5220160700978,15.8174,13.8794,4
"4022",1,32,1,-31,-40.3871846326014,25.8174,13.8794,14
"4023",1,20,14,-6,-17.3531673635753,0.8174,0.8794,2
"4024",1,17,10,-7,-15.8271386121108,1.8174,4.8794,-1
"4025",1,13,23,10,-2.53505856367949,-15.1826,-8.1206,-5
"4026",1,24,13,-11,-23.0394833539436,5.8174,1.8794,6
"4027",1,21,26,5,-10.8155985905275,-10.1826,-11.1206,3
"4028",1,27,29,2,-16.8653043969343,-7.1826,-14.1206,9
"4029",1,18,16,-2,-13.3985192850195,-3.1826,-1.1206,0
"4030",1,21,11,-10,-20.4327692426427,4.8174,3.8794,3
"4031",1,28,21,-7,-23.1194055410378,1.8174,-6.1206,10
"4032",1,18,26,8,-7.10669617217038,-13.1826,-11.1206,0
"4033",1,15,22,7,-5.55891359795001,-12.1826,-7.1206,-3
"4034",1,19,3,-16,-22.3162895973999,10.8174,11.8794,1
"4035",1,19,17,-2,-14.0745320323624,-3.1826,-2.1206,1
"4036",1,25,23,-2,-18.0661882751439,-3.1826,-8.1206,7
"4037",1,21,13,-8,-18.8782206365595,2.8174,1.8794,3
"4038",1,16,24,8,-6.11483961160913,-13.1826,-9.1206,-2
"4039",1,20,27,7,-9.36916123285398,-12.1826,-12.1206,2
"4040",1,16,0,-16,-20.3578654304632,10.8174,14.8794,-2
"4041",1,23,5,-18,-26.5188716828285,12.8174,9.8794,5
"4042",1,19,4,-15,-21.7962315220372,9.8174,10.8794,1
"4043",1,17,15,-2,-12.7233741748326,-3.1826,-0.1206,-1
"4044",1,17,14,-3,-13.0622702255617,-2.1826,0.8794,-1
"4045",1,23,0,-23,-29.459153825595,17.8174,14.8794,5
"4046",1,30,12,-18,-31.4366090339707,12.8174,2.8794,12
"4047",1,22,29,7,-10.863200860545,-12.1826,-14.1206,4
"4048",1,11,5,-6,-10.7817988418886,0.8174,9.8794,-7
"4049",1,25,21,-4,-19.5844694743774,-1.1826,-6.1206,7
"4050",1,14,13,-1,-9.8520792448544,-4.1826,1.8794,-4
"4051",1,14,26,12,-2.32486653043533,-17.1826,-11.1206,-4
"4052",1,17,30,13,-3.59077036333556,-18.1826,-15.1206,-1
"4053",1,24,0,-24,-30.5968170924071,18.8174,14.8794,6
"4054",1,16,24,8,-5.83581391997686,-13.1826,-9.1206,-2
"4055",1,22,1,-21,-27.3652090209424,15.8174,13.8794,4
"4056",1,28,19,-9,-24.6297282830375,3.8174,-4.1206,10
"4057",1,18,24,6,-8.22159333257266,-11.1826,-9.1206,0
"4058",1,21,2,-19,-25.2870300303394,13.8174,12.8794,3
"4059",1,14,9,-5,-12.2519557291685,-0.1826,5.8794,-4
"4060",1,24,29,5,-13.2967780689825,-10.1826,-14.1206,6
"4061",1,20,29,9,-7.94292364356634,-14.1826,-14.1206,2
"4062",1,23,2,-21,-28.1658757151401,15.8174,12.8794,5
"4063",1,19,1,-18,-23.6537117310473,12.8174,13.8794,1
"4064",1,17,10,-7,-15.5468358708524,1.8174,4.8794,-1
"4065",1,16,10,-6,-14.3747272972143,0.8174,4.8794,-2
"4066",1,19,3,-16,-22.5644730668159,10.8174,11.8794,1
"4067",1,22,24,2,-13.4899225055768,-7.1826,-9.1206,4
"4068",1,15,7,-8,-14.8771031051608,2.8174,7.8794,-3
"4069",1,28,9,-19,-30.4118822760179,13.8174,5.8794,10
"4070",1,28,19,-9,-24.3061781922405,3.8174,-4.1206,10
"4071",1,18,16,-2,-13.7204822452331,-3.1826,-1.1206,0
"4072",1,19,1,-18,-23.8726988358188,12.8174,13.8794,1
"4073",1,27,21,-6,-21.889450153144,0.8174,-6.1206,9
"4074",1,20,16,-4,-15.9623208357973,-1.1826,-1.1206,2
"4075",1,15,27,12,-3.03536642778744,-17.1826,-12.1206,-3
"4076",1,22,3,-19,-26.1863862068664,13.8174,11.8794,4
"4077",1,20,23,3,-12.0096041161334,-8.1826,-8.1206,2
"4078",1,15,3,-12,-17.2058427424477,6.8174,11.8794,-3
"4079",1,22,18,-4,-17.1732390669457,-1.1826,-3.1206,4
"4080",1,22,10,-12,-22.1886464443225,6.8174,4.8794,4
"4081",1,17,1,-16,-21.0800396955271,10.8174,13.8794,-1
"4082",1,24,25,1,-15.6405037951144,-6.1826,-10.1206,6
"4083",1,17,21,4,-8.93517036424922,-9.1826,-6.1206,-1
"4084",1,16,25,9,-5.05546896922081,-14.1826,-10.1206,-2
"4085",1,25,1,-24,-31.4997331211956,18.8174,13.8794,7
"4086",1,12,30,18,2.87222233233647,-23.1826,-15.1206,-6
"4087",1,17,21,4,-9.10657099295931,-9.1826,-6.1206,-1
"4088",1,17,19,2,-10.2149007192821,-7.1826,-4.1206,-1
"4089",1,18,13,-5,-14.9005782513871,-0.1826,1.8794,0
"4090",1,21,10,-11,-20.7104050226468,5.8174,4.8794,3
"4091",1,23,17,-6,-19.0206716844344,0.8174,-2.1206,5
"4092",1,11,3,-8,-11.9926773424436,2.8174,11.8794,-7
"4093",1,29,9,-20,-31.4647321927464,14.8174,5.8794,11
"4094",1,26,30,4,-15.325756983462,-9.1826,-15.1206,8
"4095",1,25,30,5,-13.8823007815326,-10.1826,-15.1206,7
"4096",1,23,26,3,-13.6389140905315,-8.1826,-11.1206,5
"4097",1,22,25,3,-12.9481928944287,-8.1826,-10.1206,4
"4098",1,21,0,-21,-26.8769742208135,15.8174,14.8794,3
"4099",1,13,5,-8,-13.5346520661778,2.8174,9.8794,-5
"4100",1,25,4,-21,-29.4687937273664,15.8174,10.8794,7
"4101",1,19,25,6,-9.09701099452804,-11.1826,-10.1206,1
"4102",1,15,20,5,-6.90137442112176,-10.1826,-5.1206,-3
"4103",1,12,22,10,-1.80399691544192,-15.1826,-7.1206,-6
"4104",1,14,1,-13,-16.9454903729724,7.8174,13.8794,-4
"4105",1,26,19,-7,-22.0008310309189,1.8174,-4.1206,8
"4106",1,13,4,-9,-14.0648308576979,3.8174,10.8794,-5
"4107",1,8,16,8,-0.192503284238485,-13.1826,-1.1206,-10
"4108",1,15,22,7,-5.5366417889032,-12.1826,-7.1206,-3
"4109",1,22,21,-1,-15.3038878489739,-4.1826,-6.1206,4
"4110",1,15,2,-13,-17.878205602248,7.8174,12.8794,-3
"4111",1,20,10,-10,-19.1868825487393,4.8174,4.8794,2
"4112",1,14,12,-2,-10.7304275764738,-3.1826,2.8794,-4
"4113",1,20,5,-15,-22.5253419549896,9.8174,9.8794,2
"4114",1,12,25,13,-0.0944239912735493,-18.1826,-10.1206,-6
"4115",1,19,30,11,-6.35182925288511,-16.1826,-15.1206,1
"4116",1,23,27,4,-13.5521829247972,-9.1826,-12.1206,5
"4117",1,22,13,-9,-20.2582672266999,3.8174,1.8794,4
"4118",1,15,25,10,-4.02584208160703,-15.1826,-10.1206,-3
"4119",1,23,11,-12,-22.9043823925538,6.8174,3.8794,5
"4120",1,32,8,-24,-36.4047273638122,18.8174,6.8794,14
"4121",1,28,8,-20,-30.9591918495562,14.8174,6.8794,10
"4122",1,22,4,-18,-25.7605936016158,12.8174,10.8794,4
"4123",1,25,6,-19,-28.1862201023118,13.8174,8.8794,7
"4124",1,16,0,-16,-20.239976397859,10.8174,14.8794,-2
"4125",1,22,12,-10,-20.7700364459083,4.8174,2.8794,4
"4126",1,21,27,6,-10.5461878487688,-11.1826,-12.1206,3
"4127",1,23,4,-19,-26.9829664950002,13.8174,10.8794,5
"4128",1,18,2,-16,-21.6533291036803,10.8174,12.8794,0
"4129",1,13,28,15,0.458475109806431,-20.1826,-13.1206,-5
"4130",1,14,8,-6,-13.0703149478984,0.8174,6.8794,-4
"4131",1,25,13,-12,-24.0544299233472,6.8174,1.8794,7
"4132",1,16,1,-15,-19.6602727853227,9.8174,13.8794,-2
"4133",1,18,5,-13,-19.8170895581791,7.8174,9.8794,0
"4134",1,20,3,-17,-23.6536454852004,11.8174,11.8794,2
"4135",1,25,13,-12,-23.8607130987507,6.8174,1.8794,7
"4136",1,18,25,7,-7.84349686266421,-12.1826,-10.1206,0
"4137",1,24,9,-15,-25.2201613750293,9.8174,5.8794,6
"4138",1,22,11,-11,-21.4411589114324,5.8174,3.8794,4
"4139",1,12,22,10,-1.85256227223989,-15.1826,-7.1206,-6
"4140",1,21,8,-13,-21.9359716248431,7.8174,6.8794,3
"4141",1,14,28,14,-0.969287413053869,-19.1826,-13.1206,-4
"4142",1,23,9,-14,-24.0241407121911,8.8174,5.8794,5
"4143",1,20,2,-18,-24.2626448703579,12.8174,12.8794,2
"4144",1,20,13,-7,-17.5474570084681,1.8174,1.8794,2
"4145",1,24,23,-1,-16.8731060739357,-4.1826,-8.1206,6
"4146",1,12,7,-5,-10.9014070066857,-0.1826,7.8794,-6
"4147",1,26,24,-2,-18.5812856113741,-3.1826,-9.1206,8
"4148",1,24,30,6,-12.8543710764513,-11.1826,-15.1206,6
"4149",1,26,18,-8,-22.4386902258264,2.8174,-3.1206,8
"4150",1,21,1,-20,-26.4009107512271,14.8174,13.8794,3
"4151",1,12,8,-4,-10.5023063022366,-1.1826,6.8794,-6
"4152",1,15,4,-11,-16.6054602245539,5.8174,10.8794,-3
"4153",1,12,13,1,-7.17781084343862,-6.1826,1.8794,-6
"4154",1,21,20,-1,-14.6424957558085,-4.1826,-5.1206,3
"4155",1,23,6,-17,-25.6822622009244,11.8174,8.8794,5
"4156",1,19,23,4,-10.3239909316155,-9.1826,-8.1206,1
"4157",1,18,26,8,-7.45356132719577,-13.1826,-11.1206,0
"4158",1,20,7,-13,-21.3501825161015,7.8174,7.8794,2
"4159",1,19,9,-10,-19.0540831668731,4.8174,5.8794,1
"4160",1,13,27,14,-0.263018925975742,-19.1826,-12.1206,-5
"4161",1,12,18,6,-4.24847288629494,-11.1826,-3.1206,-6
"4162",1,19,17,-2,-13.9274241741376,-3.1826,-2.1206,1
"4163",1,23,23,0,-15.5925632207335,-5.1826,-8.1206,5
"4164",1,15,9,-6,-13.601391490133,0.8174,5.8794,-3
"4165",1,19,2,-17,-23.1030421491648,11.8174,12.8794,1
"4166",1,21,15,-6,-17.6346333748751,0.8174,-0.1206,3
"4167",1,20,17,-3,-15.3966159875576,-2.1826,-2.1206,2
"4168",1,13,21,8,-3.90323095752342,-13.1826,-6.1206,-5
"4169",1,20,6,-14,-21.959553977069,8.8174,8.8794,2
"4170",1,13,9,-4,-11.13553860355,-1.1826,5.8794,-5
"4171",1,24,6,-18,-27.1762709649882,12.8174,8.8794,6
"4172",1,27,17,-10,-24.4371123237563,4.8174,-2.1206,9
"4173",1,21,19,-2,-15.3057641882259,-3.1826,-4.1206,3
"4174",1,15,21,6,-6.5249240953306,-11.1826,-6.1206,-3
"4175",1,19,26,7,-8.62021917452808,-12.1826,-11.1206,1
"4176",1,17,28,11,-4.89201559416613,-16.1826,-13.1206,-1
"4177",1,13,1,-12,-15.9406544170268,6.8174,13.8794,-5
"4178",1,25,29,4,-14.807301547636,-9.1826,-14.1206,7
"4179",1,20,0,-20,-25.6475102697987,14.8174,14.8794,2
"4180",1,23,24,1,-15.1594623610001,-6.1826,-9.1206,5
"4181",1,12,10,-2,-9.21890100667277,-3.1826,4.8794,-6
"4182",1,27,12,-15,-27.1795913206204,9.8174,2.8794,9
"4183",1,24,6,-18,-27.2571299640588,12.8174,8.8794,6
"4184",1,17,11,-6,-14.9754176031195,0.8174,3.8794,-1
"4185",1,20,25,5,-10.401341837242,-10.1826,-10.1206,2
"4186",1,25,29,4,-14.6117573763695,-9.1826,-14.1206,7
"4187",1,21,1,-20,-26.1091063629309,14.8174,13.8794,3
"4188",1,20,2,-18,-24.3131438775275,12.8174,12.8794,2
"4189",1,27,26,-1,-18.8055789115077,-4.1826,-11.1206,9
"4190",1,19,17,-2,-13.9576613696149,-3.1826,-2.1206,1
"4191",1,30,13,-17,-30.7989877963623,11.8174,1.8794,12
"4192",1,23,6,-17,-25.9936400837382,11.8174,8.8794,5
"4193",1,18,14,-4,-14.5895501743418,-1.1826,0.8794,0
"4194",1,11,29,18,3.74306485584746,-23.1826,-14.1206,-7
"4195",1,23,20,-3,-17.3410058803612,-2.1826,-5.1206,5
"4196",1,20,13,-7,-17.9342867648158,1.8174,1.8794,2
"4197",1,18,10,-8,-17.2257597356699,2.8174,4.8794,0
"4198",1,18,0,-18,-22.9563093243222,12.8174,14.8794,0
"4199",1,23,29,6,-12.1114671908442,-11.1826,-14.1206,5
"4200",1,28,30,2,-17.8051771253969,-7.1826,-15.1206,10
"4201",1,21,9,-12,-21.0779289841818,6.8174,5.8794,3
"4202",1,23,26,3,-13.7991739601616,-8.1826,-11.1206,5
"4203",1,18,7,-11,-18.6424938168498,5.8174,7.8794,0
"4204",1,20,2,-18,-24.0930481090545,12.8174,12.8794,2
"4205",1,25,6,-19,-28.1843599775848,13.8174,8.8794,7
"4206",1,23,6,-17,-25.9397473686526,11.8174,8.8794,5
"4207",1,18,27,9,-6.63565107667133,-14.1826,-12.1206,0
"4208",1,15,16,1,-9.37289265974139,-6.1826,-1.1206,-3
"4209",1,24,11,-13,-24.0147230564852,7.8174,3.8794,6
"4210",1,18,30,12,-4.8670056962711,-17.1826,-15.1206,0
"4211",1,19,30,11,-6.22875633371772,-16.1826,-15.1206,1
"4212",1,15,7,-8,-14.6645188364726,2.8174,7.8794,-3
"4213",1,20,1,-19,-24.9009276508163,13.8174,13.8794,2
"4214",1,20,2,-18,-24.4144566871566,12.8174,12.8794,2
"4215",1,20,30,10,-7.30165869576044,-15.1826,-15.1206,2
"4216",1,19,17,-2,-14.2807163939832,-3.1826,-2.1206,1
"4217",1,27,9,-18,-29.2825971486539,12.8174,5.8794,9
"4218",1,24,10,-14,-24.8424517617591,8.8174,4.8794,6
"4219",1,19,5,-14,-21.1846918863701,8.8174,9.8794,1
"4220",1,24,7,-17,-26.619263358021,11.8174,7.8794,6
"4221",1,18,6,-12,-19.2553456944356,6.8174,8.8794,0
"4222",1,20,23,3,-11.5757404864859,-8.1826,-8.1206,2
"4223",1,22,5,-17,-25.1370955092352,11.8174,9.8794,4
"4224",1,14,12,-2,-10.357801366941,-3.1826,2.8794,-4
"4225",1,24,1,-23,-30.030137596961,17.8174,13.8794,6
"4226",1,26,15,-11,-24.5300103340107,5.8174,-0.1206,8
"4227",1,14,18,4,-6.74687988617022,-9.1826,-3.1206,-4
"4228",1,14,12,-2,-10.6103365610303,-3.1826,2.8794,-4
"4229",1,20,25,5,-10.5604456097585,-10.1826,-10.1206,2
"4230",1,20,10,-10,-19.6155423985121,4.8174,4.8794,2
"4231",1,29,14,-15,-28.8116414341579,9.8174,0.8794,11
"4232",1,29,21,-8,-24.7039628003071,2.8174,-6.1206,11
"4233",1,15,16,1,-9.35497241417238,-6.1826,-1.1206,-3
"4234",1,22,7,-15,-24.0797553525279,9.8174,7.8794,4
"4235",1,28,7,-21,-31.8468566842136,15.8174,7.8794,10
"4236",1,19,11,-8,-17.3475232368443,2.8174,3.8794,1
"4237",1,11,8,-3,-9.07275355347381,-2.1826,6.8794,-7
"4238",1,22,13,-9,-20.4223607141449,3.8174,1.8794,4
"4239",1,16,20,4,-8.34775621013424,-9.1826,-5.1206,-2
"4240",1,18,20,2,-10.8555872297546,-7.1826,-5.1206,0
"4241",1,15,6,-9,-15.3670909326532,3.8174,8.8794,-3
"4242",1,26,21,-5,-20.6174081051827,-0.1826,-6.1206,8
"4243",1,13,5,-8,-13.4173388713744,2.8174,9.8794,-5
"4244",1,21,14,-7,-18.5852798948414,1.8174,0.8794,3
"4245",1,11,27,16,2.36113253726267,-21.1826,-12.1206,-7
"4246",1,16,10,-6,-14.1171916880049,0.8174,4.8794,-2
"4247",1,16,23,7,-6.5196541253452,-12.1826,-8.1206,-2
"4248",1,19,13,-6,-16.3460236391229,0.8174,1.8794,1
"4249",1,16,18,2,-9.06984059379135,-7.1826,-3.1206,-2
"4250",1,22,11,-11,-21.4917655130398,5.8174,3.8794,4
"4251",1,12,21,9,-2.705354910762,-14.1826,-6.1206,-6
"4252",1,25,26,1,-16.4137812517432,-6.1826,-11.1206,7
"4253",1,21,28,7,-9.81048764764168,-12.1826,-13.1206,3
"4254",1,15,26,11,-3.38896835881572,-16.1826,-11.1206,-3
"4255",1,23,30,7,-11.2923381506516,-12.1826,-15.1206,5
"4256",1,18,3,-15,-21.0119878461589,9.8174,11.8794,0
"4257",1,17,21,4,-8.86418049538657,-9.1826,-6.1206,-1
"4258",1,13,12,-1,-9.10930963508067,-4.1826,2.8794,-5
"4259",1,16,18,2,-9.76199281215065,-7.1826,-3.1206,-2
"4260",1,21,17,-4,-16.4272920430854,-1.1826,-2.1206,3
"4261",1,22,11,-11,-21.7912262490792,5.8174,3.8794,4
"4262",1,12,14,2,-6.50542555262869,-7.1826,0.8794,-6
"4263",1,22,10,-12,-22.1224818174065,6.8174,4.8794,4
"4264",1,25,19,-6,-20.6535835151964,0.8174,-4.1206,7
"4265",1,23,22,-1,-16.2283180296914,-4.1826,-7.1206,5
"4266",1,24,2,-22,-29.7150910062873,16.8174,12.8794,6
"4267",1,21,4,-17,-24.2979723056058,11.8174,10.8794,3
"4268",1,14,17,3,-7.61768383145539,-8.1826,-2.1206,-4
"4269",1,18,4,-14,-20.4781095559275,8.8174,10.8794,0
"4270",1,28,3,-25,-33.9783511010967,19.8174,11.8794,10
"4271",1,19,5,-14,-21.3217326793635,8.8174,9.8794,1
"4272",1,21,29,8,-9.35048010633255,-13.1826,-14.1206,3
"4273",1,18,13,-5,-14.9067266133794,-0.1826,1.8794,0
"4274",1,22,10,-12,-22.1236875134711,6.8174,4.8794,4
"4275",1,19,6,-13,-20.6987167881004,7.8174,8.8794,1
"4276",1,25,1,-24,-31.7123725850219,18.8174,13.8794,7
"4277",1,23,2,-21,-28.4657322114721,15.8174,12.8794,5
"4278",1,18,5,-13,-19.7834733658197,7.8174,9.8794,0
"4279",1,17,23,6,-8.02943946572701,-11.1826,-8.1206,-1
"4280",1,17,29,12,-4.32506796304258,-17.1826,-14.1206,-1
"4281",1,16,22,6,-7.11052155140856,-11.1826,-7.1206,-2
"4282",1,17,25,8,-6.44387029564788,-13.1826,-10.1206,-1
"4283",1,21,18,-3,-16.1341685947807,-2.1826,-3.1206,3
"4284",1,21,25,4,-11.7602208722354,-9.1826,-10.1206,3
"4285",1,16,17,1,-9.91302825291935,-6.1826,-2.1206,-2
"4286",1,23,20,-3,-17.4404926635175,-2.1826,-5.1206,5
"4287",1,20,3,-17,-23.4880639906519,11.8174,11.8794,2
"4288",1,14,0,-14,-17.7770506135227,8.8174,14.8794,-4
"4289",1,12,22,10,-2.12049689657074,-15.1826,-7.1206,-6
"4290",1,21,17,-4,-16.4687395039401,-1.1826,-2.1206,3
"4291",1,18,5,-13,-19.8905329385869,7.8174,9.8794,0
"4292",1,20,9,-11,-20.1875678789703,5.8174,5.8794,2
"4293",1,20,18,-2,-14.7768697672297,-3.1826,-3.1206,2
"4294",1,16,3,-13,-18.5169191892153,7.8174,11.8794,-2
"4295",1,16,28,12,-3.47582488231029,-17.1826,-13.1206,-2
"4296",1,25,22,-3,-18.9040403502001,-2.1826,-7.1206,7
"4297",1,19,8,-11,-19.3595760511702,5.8174,6.8794,1
"4298",1,26,22,-4,-19.8184057527158,-1.1826,-7.1206,8
"4299",1,16,3,-13,-18.5616241052857,7.8174,11.8794,-2
"4300",1,21,21,0,-13.9890547115626,-5.1826,-6.1206,3
"4301",1,16,3,-13,-18.4063562601106,7.8174,11.8794,-2
"4302",1,20,6,-14,-21.8180297181402,8.8174,8.8794,2
"4303",1,22,24,2,-13.7636582869551,-7.1826,-9.1206,4
"4304",1,24,29,5,-13.2672118022227,-10.1826,-14.1206,6
"4305",1,24,1,-23,-30.2264756179855,17.8174,13.8794,6
"4306",1,18,14,-4,-14.5938900281516,-1.1826,0.8794,0
"4307",1,20,11,-9,-19.1243017039679,3.8174,3.8794,2
"4308",1,23,6,-17,-25.6200454621888,11.8174,8.8794,5
"4309",1,21,14,-7,-18.1038732005211,1.8174,0.8794,3
"4310",1,17,3,-14,-20.0750654207283,8.8174,11.8794,-1
"4311",1,21,0,-21,-26.6532573431932,15.8174,14.8794,3
"4312",1,17,10,-7,-15.3375309090266,1.8174,4.8794,-1
"4313",1,26,26,0,-17.5376046086006,-5.1826,-11.1206,8
"4314",1,14,20,6,-5.6629135877159,-11.1826,-5.1206,-4
"4315",1,19,21,2,-11.8321860691105,-7.1826,-6.1206,1
"4316",1,22,20,-2,-15.9776468503373,-3.1826,-5.1206,4
"4317",1,20,13,-7,-17.4014745605067,1.8174,1.8794,2
"4318",1,21,11,-10,-20.3297391133182,4.8174,3.8794,3
"4319",1,24,28,4,-13.7255561127476,-9.1826,-13.1206,6
"4320",1,26,11,-15,-26.7556346513801,9.8174,3.8794,8
"4321",1,24,23,-1,-16.8142616262078,-4.1826,-8.1206,6
"4322",1,22,19,-3,-16.7007206951626,-2.1826,-4.1206,4
"4323",1,16,30,14,-2.29046370640164,-19.1826,-15.1206,-2
"4324",1,20,15,-5,-16.5618683550341,-0.1826,-0.1206,2
"4325",1,20,19,-1,-14.2668864726561,-4.1826,-4.1206,2
"4326",1,22,30,8,-9.94682580545671,-13.1826,-15.1206,4
"4327",1,17,7,-10,-17.5518469281427,4.8174,7.8794,-1
"4328",1,19,17,-2,-14.1928534891952,-3.1826,-2.1206,1
"4329",1,22,25,3,-13.0763562118837,-8.1826,-10.1206,4
"4330",1,20,7,-13,-21.490232848848,7.8174,7.8794,2
"4331",1,22,1,-21,-27.4277550763243,15.8174,13.8794,4
"4332",1,12,8,-4,-10.2599314133292,-1.1826,6.8794,-6
"4333",1,22,6,-16,-24.5731104295546,10.8174,8.8794,4
"4334",1,21,5,-16,-23.752721840089,10.8174,9.8794,3
"4335",1,23,24,1,-15.073483879871,-6.1826,-9.1206,5
"4336",1,14,2,-12,-16.6706039729501,6.8174,12.8794,-4
"4337",1,25,11,-14,-25.4412800010338,8.8174,3.8794,7
"4338",1,20,8,-12,-20.7320352553385,6.8174,6.8794,2
"4339",1,20,21,1,-12.8659392784043,-6.1826,-6.1206,2
"4340",1,16,12,-4,-13.2090326130922,-1.1826,2.8794,-2
"4341",1,14,7,-7,-13.3617636027544,1.8174,7.8794,-4
"4342",1,18,13,-5,-15.1010582037896,-0.1826,1.8794,0
"4343",1,20,9,-11,-20.0297350105027,5.8174,5.8794,2
"4344",1,25,25,0,-16.9486114760643,-5.1826,-10.1206,7
"4345",1,17,19,2,-10.270156418606,-7.1826,-4.1206,-1
"4346",1,18,23,5,-9.09733156843172,-10.1826,-8.1206,0
"4347",1,20,19,-1,-14.5473661446264,-4.1826,-4.1206,2
"4348",1,21,12,-9,-19.6051068865778,3.8174,2.8794,3
"4349",1,26,16,-10,-23.704343886245,4.8174,-1.1206,8
"4350",1,17,11,-6,-14.9513832350926,0.8174,3.8794,-1
"4351",1,15,15,0,-10.1216880617842,-5.1826,-0.1206,-3
"4352",1,21,11,-10,-20.229625103845,4.8174,3.8794,3
"4353",1,10,23,13,1.26903372164574,-18.1826,-8.1206,-8
"4354",1,19,20,1,-12.0365399887537,-6.1826,-5.1206,1
"4355",1,27,1,-26,-34.0249965891541,20.8174,13.8794,9
"4356",1,21,15,-6,-17.757467220574,0.8174,-0.1206,3
"4357",1,17,5,-12,-18.4536975637408,6.8174,9.8794,-1
"4358",1,17,26,9,-5.99284358327343,-14.1826,-11.1206,-1
"4359",1,22,5,-17,-25.1122684103184,11.8174,9.8794,4
"4360",1,23,23,0,-15.4961633672746,-5.1826,-8.1206,5
"4361",1,15,14,-1,-10.5139429322253,-4.1826,0.8794,-3
"4362",1,22,13,-9,-20.3638425671908,3.8174,1.8794,4
"4363",1,21,25,4,-11.8329735507649,-9.1826,-10.1206,3
"4364",1,25,8,-17,-27.0670965619026,11.8174,6.8794,7
"4365",1,14,9,-5,-12.2216265292168,-0.1826,5.8794,-4
"4366",1,25,15,-10,-22.7056257072111,4.8174,-0.1206,7
"4367",1,22,8,-14,-23.4130396563266,8.8174,6.8794,4
"4368",1,16,1,-15,-19.6708153298789,9.8174,13.8794,-2
"4369",1,20,27,7,-8.87027378323492,-12.1826,-12.1206,2
"4370",1,17,25,8,-6.43909549834816,-13.1826,-10.1206,-1
"4371",1,26,29,3,-15.5826666306141,-8.1826,-14.1206,8
"4372",1,16,28,12,-3.12546905612712,-17.1826,-13.1206,-2
"4373",1,25,27,2,-16.0015654191932,-7.1826,-12.1206,7
"4374",1,24,5,-19,-27.8739934702615,13.8174,9.8794,6
"4375",1,20,13,-7,-17.8144818889531,1.8174,1.8794,2
"4376",1,23,28,5,-12.7394721422359,-10.1826,-13.1206,5
"4377",1,18,19,1,-11.3936257103347,-6.1826,-4.1206,0
"4378",1,19,7,-12,-20.0107056124774,6.8174,7.8794,1
"4379",1,14,6,-8,-14.2530173021599,2.8174,8.8794,-4
"4380",1,22,3,-19,-26.2121904288566,13.8174,11.8794,4
"4381",1,24,27,3,-14.3756230675977,-8.1826,-12.1206,6
"4382",1,19,6,-13,-20.6122381209361,7.8174,8.8794,1
"4383",1,12,1,-11,-14.6844998633215,5.8174,13.8794,-6
"4384",1,19,5,-14,-21.2877984729386,8.8174,9.8794,1
"4385",1,24,22,-2,-17.4260750130097,-3.1826,-7.1206,6
"4386",1,25,4,-21,-29.5225410351139,15.8174,10.8794,7
"4387",1,17,4,-13,-19.4075562838549,7.8174,10.8794,-1
"4388",1,19,2,-17,-23.0055209215136,11.8174,12.8794,1
"4389",1,27,7,-20,-30.3494175927841,14.8174,7.8794,9
"4390",1,20,24,4,-11.125309769502,-9.1826,-9.1206,2
"4391",1,19,22,3,-11.047598707792,-8.1826,-7.1206,1
"4392",1,25,5,-20,-28.9041440907399,14.8174,9.8794,7
"4393",1,15,19,4,-7.40641282770119,-9.1826,-4.1206,-3
"4394",1,11,9,-2,-8.39306160320521,-3.1826,5.8794,-7
"4395",1,24,23,-1,-17.1652528511121,-4.1826,-8.1206,6
"4396",1,15,13,-2,-11.1624051285565,-3.1826,1.8794,-3
"4397",1,20,3,-17,-23.8041820551604,11.8174,11.8794,2
"4398",1,29,1,-28,-36.7281027930636,22.8174,13.8794,11
"4399",1,13,12,-1,-9.50312169251293,-4.1826,2.8794,-5
"4400",1,19,15,-4,-15.0550984211085,-1.1826,-0.1206,1
"4401",1,21,16,-5,-17.2255773500647,-0.1826,-1.1206,3
"4402",1,19,25,6,-9.33732196533837,-11.1826,-10.1206,1
"4403",1,22,0,-22,-28.2655732605374,16.8174,14.8794,4
"4404",1,19,24,5,-10.0949419075609,-10.1826,-9.1206,1
"4405",1,21,6,-15,-23.2141509669322,9.8174,8.8794,3
"4406",1,19,0,-19,-24.3028470459192,13.8174,14.8794,1
"4407",1,18,27,9,-6.88206603680172,-14.1826,-12.1206,0
"4408",1,21,0,-21,-26.7621441277299,15.8174,14.8794,3
"4409",1,16,6,-10,-16.6921959414843,4.8174,8.8794,-2
"4410",1,28,25,-3,-20.8312943485208,-2.1826,-10.1206,10
"4411",1,14,5,-9,-14.4900743903817,3.8174,9.8794,-4
"4412",1,15,15,0,-10.0265118279833,-5.1826,-0.1206,-3
"4413",1,27,15,-12,-25.6138725100502,6.8174,-0.1206,9
"4414",1,18,12,-6,-15.5996028352797,0.8174,2.8794,0
"4415",1,24,14,-10,-22.154726931155,4.8174,0.8794,6
"4416",1,14,19,5,-6.02057454144115,-10.1826,-4.1206,-4
"4417",1,15,17,2,-9.03874433274382,-7.1826,-2.1206,-3
"4418",1,23,11,-12,-22.7636247353192,6.8174,3.8794,5
"4419",1,13,13,0,-8.76719899079561,-5.1826,1.8794,-5
"4420",1,8,22,14,3.37779906099926,-19.1826,-7.1206,-10
"4421",1,25,6,-19,-28.4116248733867,13.8174,8.8794,7
"4422",1,17,10,-7,-15.7423326657491,1.8174,4.8794,-1
"4423",1,23,18,-5,-18.5663309027207,-0.1826,-3.1206,5
"4424",1,33,5,-28,-39.5842606319582,22.8174,9.8794,15
"4425",1,19,14,-5,-15.8322614892739,-0.1826,0.8794,1
"4426",1,17,29,12,-4.19423782763835,-17.1826,-14.1206,-1
"4427",1,35,4,-31,-42.6033427552991,25.8174,10.8794,17
"4428",1,21,7,-14,-22.4684032928078,8.8174,7.8794,3
"4429",1,20,29,9,-8.25780480254117,-14.1826,-14.1206,2
"4430",1,19,0,-19,-24.3220856252737,13.8174,14.8794,1
"4431",1,24,5,-19,-27.897175870833,13.8174,9.8794,6
"4432",1,22,8,-14,-23.3304207260688,8.8174,6.8794,4
"4433",1,24,20,-4,-18.7150195716608,-1.1826,-5.1206,6
"4434",1,20,11,-9,-18.8467777758784,3.8174,3.8794,2
"4435",1,24,23,-1,-17.1786519375135,-4.1826,-8.1206,6
"4436",1,12,5,-7,-12.2122167153615,1.8174,9.8794,-6
"4437",1,21,17,-4,-16.4309132055131,-1.1826,-2.1206,3
"4438",1,21,26,5,-11.2428725520005,-10.1826,-11.1206,3
"4439",1,18,4,-14,-20.4879150284947,8.8174,10.8794,0
"4440",1,21,7,-14,-22.3210633732219,8.8174,7.8794,3
"4441",1,16,10,-6,-13.9900701238726,0.8174,4.8794,-2
"4442",1,29,11,-18,-30.6979252685732,12.8174,3.8794,11
"4443",1,23,5,-18,-26.3635013835082,12.8174,9.8794,5
"4444",1,19,30,11,-6.2168994378405,-16.1826,-15.1206,1
"4445",1,24,6,-18,-26.9311738831681,12.8174,8.8794,6
"4446",1,26,0,-26,-33.4422855168337,20.8174,14.8794,8
"4447",1,22,13,-9,-20.3401538319507,3.8174,1.8794,4
"4448",1,32,5,-27,-38.1566368780839,21.8174,9.8794,14
"4449",1,18,26,8,-7.13728093717848,-13.1826,-11.1206,0
"4450",1,24,5,-19,-27.7063577396484,13.8174,9.8794,6
"4451",1,16,18,2,-9.47922587860132,-7.1826,-3.1206,-2
"4452",1,14,29,15,-0.467888328113409,-20.1826,-14.1206,-4
"4453",1,23,10,-13,-23.2451072260848,7.8174,4.8794,5
"4454",1,19,5,-14,-21.2379999389725,8.8174,9.8794,1
"4455",1,13,26,13,-0.939753138845998,-18.1826,-11.1206,-5
"4456",1,15,28,13,-2.17793077487076,-18.1826,-13.1206,-3
"4457",1,24,25,1,-15.407185658062,-6.1826,-10.1206,6
"4458",1,22,1,-21,-27.6948871856714,15.8174,13.8794,4
"4459",1,20,13,-7,-17.5935045837532,1.8174,1.8794,2
"4460",1,18,4,-14,-20.6413894370166,8.8174,10.8794,0
"4461",1,24,22,-2,-17.5717301646954,-3.1826,-7.1206,6
"4462",1,20,16,-4,-15.7492671448214,-1.1826,-1.1206,2
"4463",1,26,17,-9,-23.2668747790079,3.8174,-2.1206,8
"4464",1,19,10,-9,-18.0530520736038,3.8174,4.8794,1
"4465",1,18,21,3,-10.4139936930893,-8.1826,-6.1206,0
"4466",1,23,3,-20,-27.3874298887585,14.8174,11.8794,5
"4467",1,24,30,6,-12.5158437897127,-11.1826,-15.1206,6
"4468",1,23,1,-22,-28.513901376208,16.8174,13.8794,5
"4469",1,17,21,4,-8.93179002467483,-9.1826,-6.1206,-1
"4470",1,20,17,-3,-15.2943390915341,-2.1826,-2.1206,2
"4471",1,13,1,-12,-15.7354884519296,6.8174,13.8794,-5
"4472",1,22,21,-1,-15.635624841837,-4.1826,-6.1206,4
"4473",1,14,19,5,-5.98532405072529,-10.1826,-4.1206,-4
"4474",1,18,9,-9,-17.6765573675812,3.8174,5.8794,0
"4475",1,21,14,-7,-18.6579163652762,1.8174,0.8794,3
"4476",1,15,22,7,-5.81212112688969,-12.1826,-7.1206,-3
"4477",1,30,16,-14,-28.6577338708052,8.8174,-1.1206,12
"4478",1,24,22,-2,-17.4819400833537,-3.1826,-7.1206,6
"4479",1,19,5,-14,-21.2240264254105,8.8174,9.8794,1
"4480",1,25,8,-17,-27.334263035093,11.8174,6.8794,7
"4481",1,11,8,-3,-9.31960870361384,-2.1826,6.8794,-7
"4482",1,18,5,-13,-20.0684372137015,7.8174,9.8794,0
"4483",1,20,8,-12,-20.5737300488896,6.8174,6.8794,2
"4484",1,29,13,-16,-29.4166122750311,10.8174,1.8794,11
"4485",1,19,27,8,-7.91165265517769,-13.1826,-12.1206,1
"4486",1,28,16,-12,-26.2961513429966,6.8174,-1.1206,10
"4487",1,13,0,-13,-16.4140572950446,7.8174,14.8794,-5
"4488",1,14,9,-5,-12.348163974239,-0.1826,5.8794,-4
"4489",1,18,27,9,-6.57869153200743,-14.1826,-12.1206,0
"4490",1,12,4,-8,-12.6482156244127,2.8174,10.8794,-6
"4491",1,18,25,7,-7.88917935033994,-12.1826,-10.1206,0
"4492",1,15,26,11,-3.14957594251068,-16.1826,-11.1206,-3
"4493",1,13,14,1,-7.89726623909879,-6.1826,0.8794,-5
"4494",1,17,25,8,-6.55698221220802,-13.1826,-10.1206,-1
"4495",1,20,27,7,-9.29121874031926,-12.1826,-12.1206,2
"4496",1,21,8,-13,-21.822023813468,7.8174,6.8794,3
"4497",1,21,15,-6,-17.5114121029766,0.8174,-0.1206,3
"4498",1,17,18,1,-10.7073839606959,-6.1826,-3.1206,-1
"4499",1,18,26,8,-7.26021605729838,-13.1826,-11.1206,0
"4500",1,26,15,-11,-24.2849367159145,5.8174,-0.1206,8
"4501",1,17,10,-7,-15.5748718651025,1.8174,4.8794,-1
"4502",1,16,24,8,-5.77329157493574,-13.1826,-9.1206,-2
"4503",1,20,18,-2,-14.4916102399971,-3.1826,-3.1206,2
"4504",1,16,28,12,-3.34083494323271,-17.1826,-13.1206,-2
"4505",1,18,27,9,-6.52672694634335,-14.1826,-12.1206,0
"4506",1,22,23,1,-14.2757813618896,-6.1826,-8.1206,4
"4507",1,15,10,-5,-12.9458037330021,-0.1826,4.8794,-3
"4508",1,22,22,0,-14.933588868262,-5.1826,-7.1206,4
"4509",1,27,8,-19,-29.7045066652345,13.8174,6.8794,9
"4510",1,25,0,-25,-31.8629698773624,19.8174,14.8794,7
"4511",1,20,20,0,-13.5985742520685,-5.1826,-5.1206,2
"4512",1,29,19,-10,-25.4923015075785,4.8174,-4.1206,11
"4513",1,16,6,-10,-16.7235951548815,4.8174,8.8794,-2
"4514",1,12,7,-5,-10.7768962233895,-0.1826,7.8794,-6
"4515",1,27,12,-15,-27.3313455263652,9.8174,2.8794,9
"4516",1,16,30,14,-2.44834237089945,-19.1826,-15.1206,-2
"4517",1,22,18,-4,-17.2049316787786,-1.1826,-3.1206,4
"4518",1,17,18,1,-10.7424776240854,-6.1826,-3.1206,-1
"4519",1,16,6,-10,-16.8054170345293,4.8174,8.8794,-2
"4520",1,23,5,-18,-26.200993228866,12.8174,9.8794,5
"4521",1,24,19,-5,-19.0007778733865,-0.1826,-4.1206,6
"4522",1,24,15,-9,-21.7953128285493,3.8174,-0.1206,6
"4523",1,28,17,-11,-25.719070441823,5.8174,-2.1206,10
"4524",1,13,21,8,-3.88654532590644,-13.1826,-6.1206,-5
"4525",1,12,9,-3,-9.59737170685426,-2.1826,5.8794,-6
"4526",1,21,3,-18,-24.5344087790273,12.8174,11.8794,3
"4527",1,19,26,7,-8.72344240557765,-12.1826,-11.1206,1
"4528",1,16,21,5,-7.50255097623809,-10.1826,-6.1206,-2
"4529",1,18,29,11,-5.4076918099305,-16.1826,-14.1206,0
"4530",1,14,27,13,-1.40879671875814,-18.1826,-12.1206,-4
"4531",1,20,1,-19,-24.9030442943366,13.8174,13.8794,2
"4532",1,16,17,1,-9.89091378539416,-6.1826,-2.1206,-2
"4533",1,17,2,-15,-20.4904707311007,9.8174,12.8794,-1
"4534",1,18,26,8,-7.29370102967142,-13.1826,-11.1206,0
"4535",1,27,28,1,-17.7753246827256,-6.1826,-13.1206,9
"4536",1,24,3,-21,-29.0708681085556,15.8174,11.8794,6
"4537",1,32,22,-10,-27.6237535480757,4.8174,-7.1206,14
"4538",1,32,16,-16,-31.5602927642811,10.8174,-1.1206,14
"4539",1,16,19,3,-8.98961335135256,-8.1826,-4.1206,-2
"4540",1,7,5,-2,-5.53422659523537,-3.1826,9.8794,-11
"4541",1,16,23,7,-6.50568726940062,-12.1826,-8.1206,-2
"4542",1,16,15,-1,-11.3745615405474,-4.1826,-0.1206,-2
"4543",1,15,1,-14,-18.5135603344202,8.8174,13.8794,-3
"4544",1,17,30,13,-3.68811756043594,-18.1826,-15.1206,-1
"4545",1,21,25,4,-11.6042328234556,-9.1826,-10.1206,3
"4546",1,24,6,-18,-26.8360227025727,12.8174,8.8794,6
"4547",1,16,4,-12,-18.2299454640998,6.8174,10.8794,-2
"4548",1,9,28,19,5.39585388959541,-24.1826,-13.1206,-9
"4549",1,21,0,-21,-26.9692136074839,15.8174,14.8794,3
"4550",1,20,24,4,-11.2108647040981,-9.1826,-9.1206,2
"4551",1,23,25,2,-14.3091224931182,-7.1826,-10.1206,5
"4552",1,18,1,-17,-22.1295952740448,11.8174,13.8794,0
"4553",1,14,11,-3,-11.128925828554,-2.1826,3.8794,-4
"4554",1,17,10,-7,-15.4902541909071,1.8174,4.8794,-1
"4555",1,17,21,4,-9.06571643114,-9.1826,-6.1206,-1
"4556",1,21,16,-5,-17.0970296557359,-0.1826,-1.1206,3
"4557",1,16,18,2,-9.5630040599408,-7.1826,-3.1206,-2
"4558",1,19,24,5,-10.1258745615251,-10.1826,-9.1206,1
"4559",1,23,19,-4,-18.0297179149329,-1.1826,-4.1206,5
"4560",1,22,17,-5,-17.8054884582678,-0.1826,-2.1206,4
"4561",1,15,2,-13,-17.6777868292133,7.8174,12.8794,-3
"4562",1,21,19,-2,-15.2300490504784,-3.1826,-4.1206,3
"4563",1,18,10,-8,-16.909527566444,2.8174,4.8794,0
"4564",1,21,24,3,-12.6029474586045,-8.1826,-9.1206,3
"4565",1,17,11,-6,-14.963474767845,0.8174,3.8794,-1
"4566",1,10,23,13,1.44657929831988,-18.1826,-8.1206,-8
"4567",1,21,4,-17,-24.3969955157932,11.8174,10.8794,3
"4568",1,19,26,7,-8.82827041221812,-12.1826,-11.1206,1
"4569",1,16,0,-16,-20.4585421680664,10.8174,14.8794,-2
"4570",1,20,26,6,-10.0631427065771,-11.1826,-11.1206,2
"4571",1,18,6,-12,-19.1322250353893,6.8174,8.8794,0
"4572",1,19,12,-7,-16.8965831296577,1.8174,2.8794,1
"4573",1,24,2,-22,-29.5108499844163,16.8174,12.8794,6
"4574",1,13,12,-1,-9.17886125127232,-4.1826,2.8794,-5
"4575",1,19,2,-17,-22.7595745280816,11.8174,12.8794,1
"4576",1,17,26,9,-6.1681471519156,-14.1826,-11.1206,-1
"4577",1,26,24,-2,-19.0370415624307,-3.1826,-9.1206,8
"4578",1,27,21,-6,-21.9405774830314,0.8174,-6.1206,9
"4579",1,18,23,5,-9.06708797055225,-10.1826,-8.1206,0
"4580",1,15,19,4,-7.44083219769209,-9.1826,-4.1206,-3
"4581",1,23,17,-6,-19.4873942338324,0.8174,-2.1206,5
"4582",1,14,26,12,-1.91752978939202,-17.1826,-11.1206,-4
"4583",1,20,4,-16,-23.0464119836225,10.8174,10.8794,2
"4584",1,20,30,10,-7.35921172162884,-15.1826,-15.1206,2
"4585",1,16,2,-14,-19.0283467053677,8.8174,12.8794,-2
"4586",1,18,19,1,-11.5368284458935,-6.1826,-4.1206,0
"4587",1,21,21,0,-14.2050104168685,-5.1826,-6.1206,3
"4588",1,19,22,3,-11.0243808514444,-8.1826,-7.1206,1
"4589",1,23,9,-14,-23.9779880116535,8.8174,5.8794,5
"4590",1,23,6,-17,-25.7198820039117,11.8174,8.8794,5
"4591",1,19,13,-6,-16.387181169083,0.8174,1.8794,1
"4592",1,22,26,4,-12.4518272065476,-9.1826,-11.1206,4
"4593",1,31,5,-26,-36.7884336602504,20.8174,9.8794,13
"4594",1,21,11,-10,-19.9456639304804,4.8174,3.8794,3
"4595",1,16,5,-11,-17.4779526814874,5.8174,9.8794,-2
"4596",1,14,5,-9,-14.8379876798717,3.8174,9.8794,-4
"4597",1,23,22,-1,-16.1668740454731,-4.1826,-7.1206,5
"4598",1,22,29,7,-10.5935477146081,-12.1826,-14.1206,4
"4599",1,21,24,3,-12.4590049239086,-8.1826,-9.1206,3
"4600",1,21,1,-20,-26.0955815459487,14.8174,13.8794,3
"4601",1,21,2,-19,-25.8637410069426,13.8174,12.8794,3
"4602",1,21,22,1,-13.5319207319284,-6.1826,-7.1206,3
"4603",1,22,26,4,-12.6121551021627,-9.1826,-11.1206,4
"4604",1,21,11,-10,-20.0723191920774,4.8174,3.8794,3
"4605",1,25,18,-7,-21.1181410996631,1.8174,-3.1206,7
"4606",1,20,6,-14,-21.9811631486937,8.8174,8.8794,2
"4607",1,16,20,4,-7.95237473810076,-9.1826,-5.1206,-2
"4608",1,25,18,-7,-21.2150899211925,1.8174,-3.1206,7
"4609",1,20,14,-6,-17.2420338618543,0.8174,0.8794,2
"4610",1,25,20,-5,-20.1986621024218,-0.1826,-5.1206,7
"4611",1,25,22,-3,-19.1617710236027,-2.1826,-7.1206,7
"4612",1,27,2,-25,-33.189610413473,19.8174,12.8794,9
"4613",1,17,11,-6,-14.9026794972312,0.8174,3.8794,-1
"4614",1,16,11,-5,-13.5845935698958,-0.1826,3.8794,-2
"4615",1,19,20,1,-12.156492956376,-6.1826,-5.1206,1
"4616",1,21,9,-12,-21.356980849151,6.8174,5.8794,3
"4617",1,22,27,5,-11.9934132732104,-10.1826,-12.1206,4
"4618",1,33,9,-24,-36.9547846994415,18.8174,5.8794,15
"4619",1,17,3,-14,-19.9359008132641,8.8174,11.8794,-1
"4620",1,13,30,17,1.71223576987732,-22.1826,-15.1206,-5
"4621",1,9,18,9,-0.489311377688419,-14.1826,-3.1206,-9
"4622",1,20,13,-7,-17.7714586690318,1.8174,1.8794,2
"4623",1,20,5,-15,-22.5994742227433,9.8174,9.8794,2
"4624",1,21,4,-17,-24.349875623536,11.8174,10.8794,3
"4625",1,26,14,-12,-24.8953263025589,6.8174,0.8794,8
"4626",1,24,15,-9,-21.6237954594077,3.8174,-0.1206,6
"4627",1,14,30,16,0.300470969315068,-21.1826,-15.1206,-4
"4628",1,12,3,-9,-13.1240943103496,3.8174,11.8794,-6
"4629",1,14,22,8,-4.48306054686266,-13.1826,-7.1206,-4
"4630",1,17,16,-1,-11.9251069576139,-4.1826,-1.1206,-1
"4631",1,15,4,-11,-16.6501672248065,5.8174,10.8794,-3
"4632",1,17,13,-4,-13.9248486512033,-1.1826,1.8794,-1
"4633",1,14,14,0,-9.43941777444079,-5.1826,0.8794,-4
"4634",1,25,0,-25,-31.6942639973027,19.8174,14.8794,7
"4635",1,28,5,-23,-32.9250339425046,17.8174,9.8794,10
"4636",1,11,30,19,4.12606583960756,-24.1826,-15.1206,-7
"4637",1,15,0,-15,-19.0749900913306,9.8174,14.8794,-3
"4638",1,23,18,-5,-18.7311877024962,-0.1826,-3.1206,5
"4639",1,19,21,2,-11.621915786465,-7.1826,-6.1206,1
"4640",1,25,5,-20,-28.9917584858589,14.8174,9.8794,7
"4641",1,18,26,8,-7.30653868588767,-13.1826,-11.1206,0
"4642",1,20,27,7,-9.1358460336124,-12.1826,-12.1206,2
"4643",1,20,30,10,-7.52030820188237,-15.1826,-15.1206,2
"4644",1,14,6,-8,-14.0779434378164,2.8174,8.8794,-4
"4645",1,20,4,-16,-22.981680330159,10.8174,10.8794,2
"4646",1,15,30,15,-1.00518967372878,-20.1826,-15.1206,-3
"4647",1,13,11,-2,-9.72004277847353,-3.1826,3.8794,-5
"4648",1,25,0,-25,-31.8063197072278,19.8174,14.8794,7
"4649",1,21,24,3,-12.2140506747424,-8.1826,-9.1206,3
"4650",1,18,16,-2,-13.2336579171837,-3.1826,-1.1206,0
"4651",1,20,10,-10,-19.5034736235881,4.8174,4.8794,2
"4652",1,15,24,9,-4.66073462803506,-14.1826,-9.1206,-3
"4653",1,18,6,-12,-19.3644885285362,6.8174,8.8794,0
"4654",1,25,25,0,-17.2826808144176,-5.1826,-10.1206,7
"4655",1,18,9,-9,-17.3642959698684,3.8174,5.8794,0
"4656",1,20,20,0,-13.442154358587,-5.1826,-5.1206,2
"4657",1,21,27,6,-10.7194639915244,-11.1826,-12.1206,3
"4658",1,22,24,2,-13.7619782660406,-7.1826,-9.1206,4
"4659",1,18,7,-11,-18.7812750455475,5.8174,7.8794,0
"4660",1,23,19,-4,-17.876207862199,-1.1826,-4.1206,5
"4661",1,13,3,-10,-14.7577606900197,4.8174,11.8794,-5
"4662",1,21,18,-3,-16.0568330797993,-2.1826,-3.1206,3
"4663",1,20,30,10,-7.40335188013145,-15.1826,-15.1206,2
"4664",1,16,1,-15,-19.654210580772,9.8174,13.8794,-2
"4665",1,13,15,2,-7.30292970145885,-7.1826,-0.1206,-5
"4666",1,30,17,-13,-28.3910294203721,7.8174,-2.1206,12
"4667",1,26,14,-12,-24.9069129159771,6.8174,0.8794,8
"4668",1,23,27,4,-13.1452257189061,-9.1826,-12.1206,5
"4669",1,13,21,8,-4.03664350016893,-13.1826,-6.1206,-5
"4670",1,19,7,-12,-20.0034533623351,6.8174,7.8794,1
"4671",1,28,5,-23,-32.995226891033,17.8174,9.8794,10
"4672",1,21,24,3,-12.4458739254792,-8.1826,-9.1206,3
"4673",1,18,30,12,-4.96388135756631,-17.1826,-15.1206,0
"4674",1,22,20,-2,-15.8835435856436,-3.1826,-5.1206,4
"4675",1,21,29,8,-9.60769032948533,-13.1826,-14.1206,3
"4676",1,16,2,-14,-19.1664319281166,8.8174,12.8794,-2
"4677",1,24,26,2,-15.0996107587931,-7.1826,-11.1206,6
"4678",1,21,27,6,-10.6245462782369,-11.1826,-12.1206,3
"4679",1,18,29,11,-5.58530539862799,-16.1826,-14.1206,0
"4680",1,15,23,8,-4.97596655436702,-13.1826,-8.1206,-3
"4681",1,21,25,4,-11.7908935142865,-9.1826,-10.1206,3
"4682",1,18,12,-6,-15.6325913304324,0.8174,2.8794,0
"4683",1,19,22,3,-10.9623866948132,-8.1826,-7.1206,1
"4684",1,26,11,-15,-26.812308956598,9.8174,3.8794,8
"4685",1,15,9,-6,-13.6469368330651,0.8174,5.8794,-3
"4686",1,25,13,-12,-24.272150951342,6.8174,1.8794,7
"4687",1,21,14,-7,-18.4769563745979,1.8174,0.8794,3
"4688",1,14,7,-7,-13.6571824941886,1.8174,7.8794,-4
"4689",1,23,28,5,-12.6014253388535,-10.1826,-13.1206,5
"4690",1,18,19,1,-11.3120892056603,-6.1826,-4.1206,0
"4691",1,15,27,12,-2.60872577310945,-17.1826,-12.1206,-3
"4692",1,22,11,-11,-21.4625904004849,5.8174,3.8794,4
"4693",1,31,19,-12,-28.3598670100776,6.8174,-4.1206,13
"4694",1,27,15,-12,-25.7429086455722,6.8174,-0.1206,9
"4695",1,20,4,-16,-22.819219973672,10.8174,10.8794,2
"4696",1,17,5,-12,-18.4852730034411,6.8174,9.8794,-1
"4697",1,25,30,5,-13.9936260441118,-10.1826,-15.1206,7
"4698",1,36,13,-23,-38.2705784261483,17.8174,1.8794,18
"4699",1,16,28,12,-3.50682143194166,-17.1826,-13.1206,-2
"4700",1,25,3,-22,-30.2880581195938,16.8174,11.8794,7
"4701",1,22,21,-1,-15.4346288378824,-4.1826,-6.1206,4
"4702",1,21,17,-4,-16.7444558248164,-1.1826,-2.1206,3
"4703",1,19,22,3,-11.1072990202948,-8.1826,-7.1206,1
"4704",1,19,19,0,-12.6741972209169,-5.1826,-4.1206,1
"4705",1,21,12,-9,-19.4778000965462,3.8174,2.8794,3
"4706",1,21,21,0,-14.1661561844675,-5.1826,-6.1206,3
"4707",1,18,1,-17,-22.1679727532285,11.8174,13.8794,0
"4708",1,20,7,-13,-21.3753572318307,7.8174,7.8794,2
"4709",1,18,30,12,-4.8953896048052,-17.1826,-15.1206,0
"4710",1,18,27,9,-6.47268443134648,-14.1826,-12.1206,0
"4711",1,22,20,-2,-16.145780078456,-3.1826,-5.1206,4
"4712",1,13,12,-1,-9.42446417781341,-4.1826,2.8794,-5
"4713",1,21,9,-12,-21.2269313712036,6.8174,5.8794,3
"4714",1,16,30,14,-2.48939871206871,-19.1826,-15.1206,-2
"4715",1,23,1,-22,-28.972756140913,16.8174,13.8794,5
"4716",1,23,17,-6,-19.1428205118483,0.8174,-2.1206,5
"4717",1,21,20,-1,-14.9122948993796,-4.1826,-5.1206,3
"4718",1,18,23,5,-9.04837182589995,-10.1826,-8.1206,0
"4719",1,23,26,3,-14.0343233021309,-8.1826,-11.1206,5
"4720",1,16,11,-5,-13.6634644555101,-0.1826,3.8794,-2
"4721",1,25,8,-17,-27.1772708659046,11.8174,6.8794,7
"4722",1,17,9,-8,-16.3865989718933,2.8174,5.8794,-1
"4723",1,13,23,10,-2.9996957508988,-15.1826,-8.1206,-5
"4724",1,21,26,5,-11.2056156580597,-10.1826,-11.1206,3
"4725",1,24,21,-3,-18.3709809665544,-2.1826,-6.1206,6
"4726",1,20,8,-12,-20.4098156124248,6.8174,6.8794,2
"4727",1,21,30,9,-8.74807035962988,-14.1826,-15.1206,3
"4728",1,24,14,-10,-22.3703695473169,4.8174,0.8794,6
"4729",1,31,15,-16,-30.9198048840375,10.8174,-0.1206,13
"4730",1,27,1,-26,-33.9268537506238,20.8174,13.8794,9
"4731",1,17,30,13,-3.39874930208739,-18.1826,-15.1206,-1
"4732",1,18,29,11,-5.54453400111722,-16.1826,-14.1206,0
"4733",1,18,15,-3,-14.1422347859878,-2.1826,-0.1206,0
"4734",1,24,20,-4,-18.7057467211433,-1.1826,-5.1206,6
"4735",1,18,1,-17,-22.188181051976,11.8174,13.8794,0
"4736",1,14,29,15,-0.304282412434362,-20.1826,-14.1206,-4
"4737",1,30,11,-19,-32.0025766326818,13.8174,3.8794,12
"4738",1,22,6,-16,-24.2714362167099,10.8174,8.8794,4
"4739",1,12,6,-6,-11.6585989332728,0.8174,8.8794,-6
"4740",1,22,22,0,-14.7859124510743,-5.1826,-7.1206,4
"4741",1,21,11,-10,-20.2552276501068,4.8174,3.8794,3
"4742",1,20,15,-5,-16.486764698301,-0.1826,-0.1206,2
"4743",1,22,7,-15,-23.6346639732898,9.8174,7.8794,4
"4744",1,19,24,5,-9.94428790183875,-10.1826,-9.1206,1
"4745",1,14,11,-3,-11.0135663721819,-2.1826,3.8794,-4
"4746",1,21,25,4,-11.7155206747001,-9.1826,-10.1206,3
"4747",1,16,17,1,-9.96987590868735,-6.1826,-2.1206,-2
"4748",1,19,23,4,-10.5868797350999,-9.1826,-8.1206,1
"4749",1,20,23,3,-11.726579480963,-8.1826,-8.1206,2
"4750",1,21,7,-14,-22.8678715256621,8.8174,7.8794,3
"4751",1,26,23,-3,-19.6244004365763,-2.1826,-8.1206,8
"4752",1,21,27,6,-10.8040030412082,-11.1826,-12.1206,3
"4753",1,27,10,-17,-28.5818505692194,11.8174,4.8794,9
"4754",1,21,25,4,-11.6654429278807,-9.1826,-10.1206,3
"4755",1,21,16,-5,-17.6127119075397,-0.1826,-1.1206,3
"4756",1,19,6,-13,-20.5943382882086,7.8174,8.8794,1
"4757",1,25,0,-25,-32.0498098656491,19.8174,14.8794,7
"4758",1,23,0,-23,-29.5577184191355,17.8174,14.8794,5
"4759",1,20,3,-17,-23.6809621588236,11.8174,11.8794,2
"4760",1,17,7,-10,-17.2409858507993,4.8174,7.8794,-1
"4761",1,18,17,-1,-12.839656343743,-4.1826,-2.1206,0
"4762",1,15,27,12,-2.87894354042818,-17.1826,-12.1206,-3
"4763",1,28,25,-3,-21.0361167883277,-2.1826,-10.1206,10
"4764",1,16,25,9,-5.43804189039063,-14.1826,-10.1206,-2
"4765",1,19,5,-14,-21.2877285038757,8.8174,9.8794,1
"4766",1,23,12,-11,-21.965399539456,5.8174,2.8794,5
"4767",1,20,14,-6,-17.1632145834099,0.8174,0.8794,2
"4768",1,14,9,-5,-12.249360299332,-0.1826,5.8794,-4
"4769",1,24,4,-20,-28.4228623140964,14.8174,10.8794,6
"4770",1,15,8,-7,-14.0326301817356,1.8174,6.8794,-3
"4771",1,14,1,-13,-17.2472176506087,7.8174,13.8794,-4
"4772",1,21,27,6,-10.7356063748838,-11.1826,-12.1206,3
"4773",1,25,6,-19,-28.3813921185769,13.8174,8.8794,7
"4774",1,10,7,-3,-8.45593248298586,-2.1826,7.8794,-8
"4775",1,24,20,-4,-18.5288681778429,-1.1826,-5.1206,6
"4776",1,20,23,3,-11.7834074965997,-8.1826,-8.1206,2
"4777",1,15,2,-13,-17.9247549596037,7.8174,12.8794,-3
"4778",1,26,25,-1,-18.2301412466482,-4.1826,-10.1206,8
"4779",1,22,24,2,-13.5087462672516,-7.1826,-9.1206,4
"4780",1,26,18,-8,-22.47635653075,2.8174,-3.1206,8
"4781",1,21,6,-15,-23.352674425791,9.8174,8.8794,3
"4782",1,10,0,-10,-12.2966349234337,4.8174,14.8794,-8
"4783",1,14,1,-13,-17.0448939244062,7.8174,13.8794,-4
"4784",1,18,9,-9,-17.601061196456,3.8174,5.8794,0
"4785",1,19,1,-18,-23.6101162780065,12.8174,13.8794,1
"4786",1,28,18,-10,-24.8663185206154,4.8174,-3.1206,10
"4787",1,16,1,-15,-19.7315502261327,9.8174,13.8794,-2
"4788",1,16,23,7,-6.70507838726737,-12.1826,-8.1206,-2
"4789",1,20,29,9,-8.11208726841807,-14.1826,-14.1206,2
"4790",1,18,8,-10,-17.7663568653772,4.8174,6.8794,0
"4791",1,18,1,-17,-21.9106800613515,11.8174,13.8794,0
"4792",1,29,26,-3,-21.7484255452303,-2.1826,-11.1206,11
"4793",1,23,22,-1,-16.1799895417468,-4.1826,-7.1206,5
"4794",1,27,23,-4,-20.5301986310559,-1.1826,-8.1206,9
"4795",1,27,30,3,-16.7892301111483,-8.1826,-15.1206,9
"4796",1,16,18,2,-9.30694446109839,-7.1826,-3.1206,-2
"4797",1,25,0,-25,-32.0223181911442,19.8174,14.8794,7
"4798",1,16,0,-16,-20.135848406847,10.8174,14.8794,-2
"4799",1,17,1,-16,-20.9432474410082,10.8174,13.8794,-1
"4800",1,25,23,-2,-18.4297419665043,-3.1826,-8.1206,7
"4801",1,12,13,1,-7.38416193582243,-6.1826,1.8794,-6
"4802",1,25,9,-16,-26.6917225300369,10.8174,5.8794,7
"4803",1,18,0,-18,-22.9463945493724,12.8174,14.8794,0
"4804",1,22,30,8,-9.91671396733558,-13.1826,-15.1206,4
"4805",1,19,27,8,-7.99030585243031,-13.1826,-12.1206,1
"4806",1,29,14,-15,-28.8996971119229,9.8174,0.8794,11
"4807",1,21,2,-19,-25.5242242660625,13.8174,12.8794,3
"4808",1,17,6,-11,-17.9243824052336,5.8174,8.8794,-1
"4809",1,12,5,-7,-11.9635876130246,1.8174,9.8794,-6
"4810",1,6,24,18,7.00685563049879,-23.1826,-9.1206,-12
"4811",1,16,18,2,-9.19962830973968,-7.1826,-3.1206,-2
"4812",1,17,28,11,-5.05916215866261,-16.1826,-13.1206,-1
"4813",1,25,23,-2,-18.3905598787609,-3.1826,-8.1206,7
"4814",1,24,0,-24,-30.9436647541465,18.8174,14.8794,6
"4815",1,22,11,-11,-21.4862746921028,5.8174,3.8794,4
"4816",1,17,0,-17,-21.7414116519825,11.8174,14.8794,-1
"4817",1,18,6,-12,-19.3269340348976,6.8174,8.8794,0
"4818",1,23,12,-11,-22.318964982775,5.8174,2.8794,5
"4819",1,21,30,9,-9.04954928607971,-14.1826,-15.1206,3
"4820",1,17,22,5,-8.36995683171301,-10.1826,-7.1206,-1
"4821",1,23,29,6,-11.8875714778144,-11.1826,-14.1206,5
"4822",1,14,20,6,-5.63228944053742,-11.1826,-5.1206,-4
"4823",1,18,15,-3,-13.8205650260005,-2.1826,-0.1206,0
"4824",1,22,19,-3,-16.7866798390334,-2.1826,-4.1206,4
"4825",1,21,17,-4,-16.791990587462,-1.1826,-2.1206,3
"4826",1,18,15,-3,-13.7889320598472,-2.1826,-0.1206,0
"4827",1,19,26,7,-8.52670294366104,-12.1826,-11.1206,1
"4828",1,17,17,0,-11.8497678455324,-5.1826,-2.1206,-1
"4829",1,17,25,8,-7.12921140033621,-13.1826,-10.1206,-1
"4830",1,18,12,-6,-15.5748935159391,0.8174,2.8794,0
"4831",1,20,8,-12,-20.5912490352409,6.8174,6.8794,2
"4832",1,27,19,-8,-23.3345287384918,2.8174,-4.1206,9
"4833",1,23,8,-15,-24.542822254766,9.8174,6.8794,5
"4834",1,14,4,-10,-15.3409878186346,4.8174,10.8794,-4
"4835",1,21,7,-14,-22.5703294914989,8.8174,7.8794,3
"4836",1,19,20,1,-12.198737336682,-6.1826,-5.1206,1
"4837",1,20,3,-17,-23.4641722086043,11.8174,11.8794,2
"4838",1,13,26,13,-0.9831323519379,-18.1826,-11.1206,-5
"4839",1,22,21,-1,-15.7839759675251,-4.1826,-6.1206,4
"4840",1,21,5,-16,-24.0448404985081,10.8174,9.8794,3
"4841",1,25,17,-8,-21.6960036376156,2.8174,-2.1206,7
"4842",1,21,22,1,-13.5948044516556,-6.1826,-7.1206,3
"4843",1,20,17,-3,-15.4842630331675,-2.1826,-2.1206,2
"4844",1,9,4,-5,-8.75120296553359,-0.1826,10.8794,-9
"4845",1,26,0,-26,-33.4142841239185,20.8174,14.8794,8
"4846",1,20,18,-2,-14.7363996550584,-3.1826,-3.1206,2
"4847",1,21,25,4,-12.0605904312302,-9.1826,-10.1206,3
"4848",1,15,12,-3,-11.9730484683173,-2.1826,2.8794,-3
"4849",1,17,5,-12,-18.6292819545691,6.8174,9.8794,-1
"4850",1,19,7,-12,-20.0055723749596,6.8174,7.8794,1
"4851",1,17,18,1,-10.5840943976175,-6.1826,-3.1206,-1
"4852",1,15,2,-13,-17.7920225272997,7.8174,12.8794,-3
"4853",1,30,17,-13,-28.1226133071406,7.8174,-2.1206,12
"4854",1,25,20,-5,-20.0963117541008,-0.1826,-5.1206,7
"4855",1,16,1,-15,-19.7381133570982,9.8174,13.8794,-2
"4856",1,17,11,-6,-15.0790738590606,0.8174,3.8794,-1
"4857",1,28,10,-18,-29.9273159650634,12.8174,4.8794,10
"4858",1,19,30,11,-6.20472425387473,-16.1826,-15.1206,1
"4859",1,21,29,8,-9.420766503973,-13.1826,-14.1206,3
"4860",1,18,11,-7,-16.3643733847869,1.8174,3.8794,0
"4861",1,23,29,6,-12.1800564652071,-11.1826,-14.1206,5
"4862",1,21,0,-21,-26.9858325221638,15.8174,14.8794,3
"4863",1,21,0,-21,-26.683797753504,15.8174,14.8794,3
"4864",1,25,23,-2,-18.3998933200329,-3.1826,-8.1206,7
"4865",1,15,14,-1,-10.358349906035,-4.1826,0.8794,-3
"4866",1,20,27,7,-9.11718089251299,-12.1826,-12.1206,2
"4867",1,26,9,-17,-28.0205642556935,11.8174,5.8794,8
"4868",1,22,9,-13,-22.5416398977138,7.8174,5.8794,4
"4869",1,23,21,-2,-16.9667631621375,-3.1826,-6.1206,5
"4870",1,11,12,1,-6.88013372825619,-6.1826,2.8794,-7
"4871",1,18,20,2,-10.9629862424879,-7.1826,-5.1206,0
"4872",1,21,7,-14,-22.6396794658861,8.8174,7.8794,3
"4873",1,20,0,-20,-25.2722662035718,14.8174,14.8794,2
"4874",1,14,14,0,-9.44305529062804,-5.1826,0.8794,-4
"4875",1,15,1,-14,-18.465881283288,8.8174,13.8794,-3
"4876",1,30,16,-14,-28.7710712296373,8.8174,-1.1206,12
"4877",1,17,2,-15,-20.3779350563771,9.8174,12.8794,-1
"4878",1,21,4,-17,-24.3370166159595,11.8174,10.8794,3
"4879",1,23,10,-13,-23.6536303167531,7.8174,4.8794,5
"4880",1,18,14,-4,-14.5923241802724,-1.1826,0.8794,0
"4881",1,19,22,3,-11.1923445575964,-8.1826,-7.1206,1
"4882",1,16,8,-8,-15.3730251702315,2.8174,6.8794,-2
"4883",1,17,30,13,-3.60196866219823,-18.1826,-15.1206,-1
"4884",1,17,15,-2,-12.3736166523451,-3.1826,-0.1206,-1
"4885",1,20,21,1,-12.9617334862232,-6.1826,-6.1206,2
"4886",1,23,6,-17,-25.7492759360508,11.8174,8.8794,5
"4887",1,23,15,-8,-20.6568350477562,2.8174,-0.1206,5
"4888",1,13,11,-2,-9.74826830281312,-3.1826,3.8794,-5
"4889",1,11,0,-11,-13.9838008028161,5.8174,14.8794,-7
"4890",1,16,23,7,-6.46526557420498,-12.1826,-8.1206,-2
"4891",1,18,8,-10,-18.1630044239475,4.8174,6.8794,0
"4892",1,19,19,0,-12.8117279689305,-5.1826,-4.1206,1
"4893",1,23,17,-6,-19.1586939418274,0.8174,-2.1206,5
"4894",1,24,24,0,-16.3920693860978,-5.1826,-9.1206,6
"4895",1,23,23,0,-15.4056513655915,-5.1826,-8.1206,5
"4896",1,16,10,-6,-14.2455380129196,0.8174,4.8794,-2
"4897",1,26,11,-15,-26.5856975368121,9.8174,3.8794,8
"4898",1,22,3,-19,-26.3939009717875,13.8174,11.8794,4
"4899",1,20,10,-10,-19.6775851258634,4.8174,4.8794,2
"4900",1,18,16,-2,-13.2473250159229,-3.1826,-1.1206,0
"4901",1,26,7,-19,-28.8643808178882,13.8174,7.8794,8
"4902",1,13,13,0,-8.67355052454262,-5.1826,1.8794,-5
"4903",1,11,24,13,0.677110429436245,-18.1826,-9.1206,-7
"4904",1,17,26,9,-5.82458215708547,-14.1826,-11.1206,-1
"4905",1,20,12,-8,-18.4700760740984,2.8174,2.8794,2
"4906",1,21,6,-15,-23.1881278040145,9.8174,8.8794,3
"4907",1,16,25,9,-5.21662569755181,-14.1826,-10.1206,-2
"4908",1,19,17,-2,-14.0905163952477,-3.1826,-2.1206,1
"4909",1,25,0,-25,-31.7264774158414,19.8174,14.8794,7
"4910",1,22,7,-15,-24.0483380653989,9.8174,7.8794,4
"4911",1,15,19,4,-7.39181720058387,-9.1826,-4.1206,-3
"4912",1,28,13,-15,-28.027185850937,9.8174,1.8794,10
"4913",1,30,11,-19,-31.7109120584441,13.8174,3.8794,12
"4914",1,17,21,4,-8.75476475724586,-9.1826,-6.1206,-1
"4915",1,20,10,-10,-19.6411160077001,4.8174,4.8794,2
"4916",1,26,5,-21,-30.1498368677514,15.8174,9.8794,8
"4917",1,26,5,-21,-30.1973514437972,15.8174,9.8794,8
"4918",1,20,0,-20,-25.4654445079373,14.8174,14.8794,2
"4919",1,28,5,-23,-33.0878921528517,17.8174,9.8794,10
"4920",1,25,28,3,-14.9393478852977,-8.1826,-13.1206,7
"4921",1,19,4,-15,-21.6450044734449,9.8174,10.8794,1
"4922",1,23,19,-4,-17.8865864083208,-1.1826,-4.1206,5
"4923",1,21,5,-16,-23.822447599532,10.8174,9.8794,3
"4924",1,10,14,4,-4.15822797717557,-9.1826,0.8794,-8
"4925",1,27,13,-14,-26.9705687957747,8.8174,1.8794,9
"4926",1,23,30,7,-11.1123230817153,-12.1826,-15.1206,5
"4927",1,24,3,-21,-28.7671296488563,15.8174,11.8794,6
"4928",1,18,20,2,-10.8496350150063,-7.1826,-5.1206,0
"4929",1,11,16,5,-4.1673735813064,-10.1826,-1.1206,-7
"4930",1,25,1,-24,-31.4967660318813,18.8174,13.8794,7
"4931",1,14,27,13,-1.45964805143206,-18.1826,-12.1206,-4
"4932",1,22,2,-20,-26.8514536531981,14.8174,12.8794,4
"4933",1,15,2,-13,-17.9337673642583,7.8174,12.8794,-3
"4934",1,28,16,-12,-26.525125962926,6.8174,-1.1206,10
"4935",1,16,3,-13,-18.777860407678,7.8174,11.8794,-2
"4936",1,18,17,-1,-12.6584044275814,-4.1826,-2.1206,0
"4937",1,17,23,6,-7.74657468064606,-11.1826,-8.1206,-1
"4938",1,18,13,-5,-15.3833684949656,-0.1826,1.8794,0
"4939",1,26,25,-1,-18.6232368289465,-4.1826,-10.1206,8
"4940",1,22,23,1,-14.2590829300867,-6.1826,-8.1206,4
"4941",1,29,20,-9,-25.2489354138018,3.8174,-5.1206,11
"4942",1,21,17,-4,-16.6247866196345,-1.1826,-2.1206,3
"4943",1,20,28,8,-8.40956735342394,-13.1826,-13.1206,2
"4944",1,21,22,1,-13.5925346409646,-6.1826,-7.1206,3
"4945",1,18,13,-5,-15.1239918175759,-0.1826,1.8794,0
"4946",1,19,26,7,-8.23593790024097,-12.1826,-11.1206,1
"4947",1,10,17,7,-2.3914933635442,-12.1826,-2.1206,-8
"4948",1,17,26,9,-5.82561171882129,-14.1826,-11.1206,-1
"4949",1,19,19,0,-12.8449067123306,-5.1826,-4.1206,1
"4950",1,17,15,-2,-12.4089976914787,-3.1826,-0.1206,-1
"4951",1,22,1,-21,-27.4910468273932,15.8174,13.8794,4
"4952",1,24,17,-7,-20.4352713860042,1.8174,-2.1206,6
"4953",1,19,21,2,-11.4508586453531,-7.1826,-6.1206,1
"4954",1,21,6,-15,-23.155987677572,9.8174,8.8794,3
"4955",1,20,17,-3,-15.1354180625738,-2.1826,-2.1206,2
"4956",1,21,12,-9,-19.8849504313459,3.8174,2.8794,3
"4957",1,21,29,8,-9.47551536908862,-13.1826,-14.1206,3
"4958",1,26,24,-2,-18.8852974701496,-3.1826,-9.1206,8
"4959",1,32,3,-29,-39.3916048969745,23.8174,11.8794,14
"4960",1,18,16,-2,-13.3763431970577,-3.1826,-1.1206,0
"4961",1,18,20,2,-10.8769527949588,-7.1826,-5.1206,0
"4962",1,24,17,-7,-20.5265937883585,1.8174,-2.1206,6
"4963",1,23,21,-2,-16.5702511920019,-3.1826,-6.1206,5
"4964",1,15,6,-9,-15.5311433192937,3.8174,8.8794,-3
"4965",1,21,13,-8,-19.2246514729045,2.8174,1.8794,3
"4966",1,17,5,-12,-18.8063660550088,6.8174,9.8794,-1
"4967",1,13,5,-8,-13.3349829642344,2.8174,9.8794,-5
"4968",1,18,5,-13,-19.7921928439255,7.8174,9.8794,0
"4969",1,18,20,2,-10.6723422927272,-7.1826,-5.1206,0
"4970",1,12,18,6,-4.37774302295609,-11.1826,-3.1206,-6
"4971",1,16,8,-8,-15.472840073013,2.8174,6.8794,-2
"4972",1,25,27,2,-15.6387405943499,-7.1826,-12.1206,7
"4973",1,18,3,-15,-21.044983242325,9.8174,11.8794,0
"4974",1,19,23,4,-10.6416897824936,-9.1826,-8.1206,1
"4975",1,23,12,-11,-22.1438635664796,5.8174,2.8794,5
"4976",1,18,29,11,-5.37743220251922,-16.1826,-14.1206,0
"4977",1,16,10,-6,-14.2631540471382,0.8174,4.8794,-2
"4978",1,22,15,-7,-19.0769944097306,1.8174,-0.1206,4
"4979",1,17,30,13,-3.64664991529519,-18.1826,-15.1206,-1
"4980",1,26,12,-14,-26.2227430546266,8.8174,2.8794,8
"4981",1,29,30,1,-19.1125325835628,-6.1826,-15.1206,11
"4982",1,9,1,-8,-10.6524103293476,2.8174,13.8794,-9
"4983",1,18,29,11,-5.41091762012827,-16.1826,-14.1206,0
"4984",1,20,10,-10,-19.5220061998265,4.8174,4.8794,2
"4985",1,19,11,-8,-17.6826471395897,2.8174,3.8794,1
"4986",1,18,18,0,-12.1540537431408,-5.1826,-3.1206,0
"4987",1,24,1,-23,-30.0471009074876,17.8174,13.8794,6
"4988",1,17,5,-12,-18.5528161387984,6.8174,9.8794,-1
"4989",1,18,28,10,-5.72697149663857,-15.1826,-13.1206,0
"4990",1,24,12,-12,-23.7655911593019,6.8174,2.8794,6
"4991",1,20,21,1,-12.8546670156727,-6.1826,-6.1206,2
"4992",1,21,2,-19,-25.550854258987,13.8174,12.8794,3
"4993",1,28,5,-23,-33.0028736212946,17.8174,9.8794,10
"4994",1,25,21,-4,-19.3743162724899,-1.1826,-6.1206,7
"4995",1,24,22,-2,-17.2974296150542,-3.1826,-7.1206,6
"4996",1,26,18,-8,-22.4086779073304,2.8174,-3.1206,8
"4997",1,27,9,-18,-29.4459904331479,12.8174,5.8794,9
"4998",1,20,20,0,-13.2858849880521,-5.1826,-5.1206,2
"4999",1,22,7,-15,-23.9985306574148,9.8174,7.8794,4
"5000",1,21,6,-15,-23.1102701615966,9.8174,8.8794,3
"5001",1,26,5,-21,-30.0993682546135,15.8174,9.8794,8
"5002",1,22,1,-21,-27.5081949154631,15.8174,13.8794,4
"5003",1,25,12,-13,-24.8606877245107,7.8174,2.8794,7
"5004",1,27,7,-20,-30.2345013737132,14.8174,7.8794,9
"5005",1,14,0,-14,-17.6353075193294,8.8174,14.8794,-4
"5006",1,21,17,-4,-16.7640301387771,-1.1826,-2.1206,3
"5007",1,18,30,12,-4.78393914837401,-17.1826,-15.1206,0
"5008",1,13,23,10,-2.49496942692375,-15.1826,-8.1206,-5
"5009",1,19,10,-9,-18.1006557688463,3.8174,4.8794,1
"5010",1,33,24,-9,-27.866177445553,3.8174,-9.1206,15
"5011",1,15,24,9,-4.61637699529816,-14.1826,-9.1206,-3
"5012",1,25,22,-3,-18.9496279153552,-2.1826,-7.1206,7
"5013",1,18,27,9,-6.42116949858736,-14.1826,-12.1206,0
"5014",1,28,24,-4,-21.4725900634801,-1.1826,-9.1206,10
"5015",1,20,3,-17,-23.7110747882432,11.8174,11.8794,2
"5016",1,25,4,-21,-29.3777930533814,15.8174,10.8794,7
"5017",1,26,27,1,-17.0444785947282,-6.1826,-12.1206,8
"5018",1,24,1,-23,-29.9291740524729,17.8174,13.8794,6
"5019",1,20,7,-13,-21.5292128236307,7.8174,7.8794,2
"5020",1,14,20,6,-5.57947040577612,-11.1826,-5.1206,-4
"5021",1,28,2,-26,-34.6426611860462,20.8174,12.8794,10
"5022",1,18,12,-6,-15.8533525531844,0.8174,2.8794,0
"5023",1,22,19,-3,-16.6522110823113,-2.1826,-4.1206,4
"5024",1,25,3,-22,-30.263457148822,16.8174,11.8794,7
"5025",1,22,26,4,-12.6962753354792,-9.1826,-11.1206,4
"5026",1,16,0,-16,-20.2402200217077,10.8174,14.8794,-2
"5027",1,13,8,-5,-11.650113738507,-0.1826,6.8794,-5
"5028",1,26,27,1,-17.2617355502649,-6.1826,-12.1206,8
"5029",1,20,26,6,-9.83948159710875,-11.1826,-11.1206,2
"5030",1,17,5,-12,-18.5651130114585,6.8174,9.8794,-1
"5031",1,24,10,-14,-24.5848583612354,8.8174,4.8794,6
"5032",1,18,8,-10,-18.054061245527,4.8174,6.8794,0
"5033",1,20,1,-19,-24.906211854582,13.8174,13.8794,2
"5034",1,20,14,-6,-17.056286030722,0.8174,0.8794,2
"5035",1,19,27,8,-8.10163079349018,-13.1826,-12.1206,1
"5036",1,22,19,-3,-16.9373243408429,-2.1826,-4.1206,4
"5037",1,19,13,-6,-16.3503480924059,0.8174,1.8794,1
"5038",1,15,20,5,-6.84258511314133,-10.1826,-5.1206,-3
"5039",1,20,14,-6,-17.5827139649818,0.8174,0.8794,2
"5040",1,24,4,-20,-28.241364133323,14.8174,10.8794,6
"5041",1,19,11,-8,-17.8048604904838,2.8174,3.8794,1
"5042",1,14,13,-1,-9.69826157893233,-4.1826,1.8794,-4
"5043",1,29,21,-8,-24.6734147691172,2.8174,-6.1206,11
"5044",1,14,19,5,-6.14260479937295,-10.1826,-4.1206,-4
"5045",1,22,20,-2,-16.2292443718204,-3.1826,-5.1206,4
"5046",1,19,17,-2,-14.0180981581405,-3.1826,-2.1206,1
"5047",1,23,13,-10,-21.5196155954447,4.8174,1.8794,5
"5048",1,17,25,8,-6.56222954214366,-13.1826,-10.1206,-1
"5049",1,21,17,-4,-16.7648976179275,-1.1826,-2.1206,3
"5050",1,22,18,-4,-17.3386713722365,-1.1826,-3.1206,4
"5051",1,26,26,0,-17.4984659505589,-5.1826,-11.1206,8
"5052",1,20,23,3,-11.8229594417014,-8.1826,-8.1206,2
"5053",1,30,3,-27,-36.6534575824077,21.8174,11.8794,12
"5054",1,20,25,5,-10.2214866372953,-10.1826,-10.1206,2
"5055",1,14,9,-5,-12.3311208840143,-0.1826,5.8794,-4
"5056",1,19,23,4,-10.2210555872773,-9.1826,-8.1206,1
"5057",1,21,23,2,-12.7174594164891,-7.1826,-8.1206,3
"5058",1,20,15,-5,-16.308089800115,-0.1826,-0.1206,2
"5059",1,24,6,-18,-27.2657206691545,12.8174,8.8794,6
"5060",1,20,8,-12,-20.73053327219,6.8174,6.8794,2
"5061",1,23,19,-4,-18.1215495485421,-1.1826,-4.1206,5
"5062",1,21,8,-13,-21.8022670847154,7.8174,6.8794,3
"5063",1,26,18,-8,-22.9617694310818,2.8174,-3.1206,8
"5064",1,22,10,-12,-22.1711386665461,6.8174,4.8794,4
"5065",1,28,2,-26,-34.5592449486529,20.8174,12.8794,10
"5066",1,24,9,-15,-25.3472702548848,9.8174,5.8794,6
"5067",1,24,22,-2,-17.6339497117815,-3.1826,-7.1206,6
"5068",1,22,20,-2,-16.4153657853898,-3.1826,-5.1206,4
"5069",1,18,8,-10,-18.0488026813674,4.8174,6.8794,0
"5070",1,20,28,8,-8.68011294495829,-13.1826,-13.1206,2
"5071",1,25,19,-6,-20.7292343796689,0.8174,-4.1206,7
"5072",1,24,12,-12,-23.729337369719,6.8174,2.8794,6
"5073",1,12,11,-1,-8.70162328877801,-4.1826,3.8794,-6
"5074",1,21,17,-4,-16.6294916501684,-1.1826,-2.1206,3
"5075",1,22,23,1,-14.2365748751582,-6.1826,-8.1206,4
"5076",1,19,1,-18,-23.6406237823121,12.8174,13.8794,1
"5077",1,27,15,-12,-26.0724760292201,6.8174,-0.1206,9
"5078",1,22,17,-5,-17.9311004546401,-0.1826,-2.1206,4
"5079",1,19,21,2,-11.8085333145373,-7.1826,-6.1206,1
"5080",1,15,12,-3,-11.9828490325532,-2.1826,2.8794,-3
"5081",1,17,17,0,-11.0862651803651,-5.1826,-2.1206,-1
"5082",1,21,22,1,-13.8373639359566,-6.1826,-7.1206,3
"5083",1,24,18,-6,-19.7427032630707,0.8174,-3.1206,6
"5084",1,25,18,-7,-21.1738065730485,1.8174,-3.1206,7
"5085",1,22,30,8,-10.2233346072332,-13.1826,-15.1206,4
"5086",1,22,22,0,-15.0227827362453,-5.1826,-7.1206,4
"5087",1,19,23,4,-10.4641734789345,-9.1826,-8.1206,1
"5088",1,22,4,-18,-26.0213527332922,12.8174,10.8794,4
"5089",1,26,10,-16,-27.1645937557804,10.8174,4.8794,8
"5090",1,25,1,-24,-31.3478999457824,18.8174,13.8794,7
"5091",1,21,19,-2,-15.2367026774725,-3.1826,-4.1206,3
"5092",1,17,30,13,-3.6791437485762,-18.1826,-15.1206,-1
"5093",1,24,25,1,-15.8020690442467,-6.1826,-10.1206,6
"5094",1,20,16,-4,-15.6879676130309,-1.1826,-1.1206,2
"5095",1,20,6,-14,-21.7332592555666,8.8174,8.8794,2
"5096",1,25,5,-20,-29.1014624436822,14.8174,9.8794,7
"5097",1,23,15,-8,-20.3099540771555,2.8174,-0.1206,5
"5098",1,20,4,-16,-23.3118759722355,10.8174,10.8794,2
"5099",1,21,9,-12,-21.1707944930189,6.8174,5.8794,3
"5100",1,23,16,-7,-19.8472597240121,1.8174,-1.1206,5
"5101",1,20,14,-6,-17.3761504040877,0.8174,0.8794,2
"5102",1,25,5,-20,-28.770840394648,14.8174,9.8794,7
"5103",1,20,6,-14,-22.1296972473506,8.8174,8.8794,2
"5104",1,17,0,-17,-21.6041031952943,11.8174,14.8794,-1
"5105",1,21,10,-11,-20.850536337679,5.8174,4.8794,3
"5106",1,21,15,-6,-17.7609465663055,0.8174,-0.1206,3
"5107",1,25,15,-10,-23.0742769272671,4.8174,-0.1206,7
"5108",1,15,11,-4,-12.2500281957551,-1.1826,3.8794,-3
"5109",1,25,13,-12,-24.1069179554683,6.8174,1.8794,7
"5110",1,28,3,-25,-34.2854318202209,19.8174,11.8794,10
"5111",1,28,26,-2,-20.1798554200127,-3.1826,-11.1206,10
"5112",1,9,14,5,-3.05292992664433,-10.1826,0.8794,-9
"5113",1,14,2,-12,-16.3887621794884,6.8174,12.8794,-4
"5114",1,14,15,1,-8.96883822150764,-6.1826,-0.1206,-4
"5115",1,17,9,-8,-15.9808840279561,2.8174,5.8794,-1
"5116",1,22,24,2,-13.5204664792001,-7.1826,-9.1206,4
"5117",1,21,6,-15,-23.1005734160397,9.8174,8.8794,3
"5118",1,23,17,-6,-19.2692144911486,0.8174,-2.1206,5
"5119",1,22,3,-19,-26.2467620870211,13.8174,11.8794,4
"5120",1,12,5,-7,-12.247699711791,1.8174,9.8794,-6
"5121",1,21,22,1,-13.729433589268,-6.1826,-7.1206,3
"5122",1,24,18,-6,-19.7950005270674,0.8174,-3.1206,6
"5123",1,21,9,-12,-21.3773736332626,6.8174,5.8794,3
"5124",1,20,10,-10,-19.6421596745997,4.8174,4.8794,2
"5125",1,20,27,7,-9.16356372319432,-12.1826,-12.1206,2
"5126",1,21,16,-5,-17.2047869129764,-0.1826,-1.1206,3
"5127",1,10,9,-1,-6.98255404018832,-4.1826,5.8794,-8
"5128",1,27,25,-2,-19.5888828808165,-3.1826,-10.1206,9
"5129",1,21,0,-21,-26.716330712152,15.8174,14.8794,3
"5130",1,19,2,-17,-22.882696837702,11.8174,12.8794,1
"5131",1,27,3,-24,-32.7096518756909,18.8174,11.8794,9
"5132",1,16,30,14,-2.404310077308,-19.1826,-15.1206,-2
"5133",1,21,2,-19,-25.5904169833338,13.8174,12.8794,3
"5134",1,22,24,2,-13.538276361299,-7.1826,-9.1206,4
"5135",1,16,25,9,-5.49126132490612,-14.1826,-10.1206,-2
"5136",1,20,2,-18,-24.1747989258512,12.8174,12.8794,2
"5137",1,24,17,-7,-20.3901414418947,1.8174,-2.1206,6
"5138",1,21,13,-8,-18.8951652559709,2.8174,1.8794,3
"5139",1,20,24,4,-10.8971596503585,-9.1826,-9.1206,2
"5140",1,14,8,-6,-12.9039388663253,0.8174,6.8794,-4
"5141",1,16,24,8,-5.84108892802545,-13.1826,-9.1206,-2
"5142",1,18,27,9,-6.65797339748948,-14.1826,-12.1206,0
"5143",1,16,26,10,-5.02639204132704,-15.1826,-11.1206,-2
"5144",1,21,14,-7,-18.2882740828446,1.8174,0.8794,3
"5145",1,21,11,-10,-20.1196034736393,4.8174,3.8794,3
"5146",1,22,20,-2,-15.9364203296532,-3.1826,-5.1206,4
"5147",1,16,2,-14,-19.083198447603,8.8174,12.8794,-2
"5148",1,22,30,8,-10.0978548057716,-13.1826,-15.1206,4
"5149",1,18,8,-10,-18.226829721169,4.8174,6.8794,0
"5150",1,19,4,-15,-21.8516008524888,9.8174,10.8794,1
"5151",1,20,17,-3,-15.3838295023327,-2.1826,-2.1206,2
"5152",1,21,18,-3,-15.8876450374282,-2.1826,-3.1206,3
"5153",1,15,0,-15,-19.1957915632218,9.8174,14.8794,-3
"5154",1,20,20,0,-13.3927051878923,-5.1826,-5.1206,2
"5155",1,27,28,1,-17.8680382819458,-6.1826,-13.1206,9
"5156",1,20,28,8,-8.6541908691745,-13.1826,-13.1206,2
"5157",1,26,6,-20,-29.75013398255,14.8174,8.8794,8
"5158",1,24,1,-23,-30.0121985923362,17.8174,13.8794,6
"5159",1,23,21,-2,-16.9263850458791,-3.1826,-6.1206,5
"5160",1,14,1,-13,-16.8320938399628,7.8174,13.8794,-4
"5161",1,15,21,6,-5.9980879389906,-11.1826,-6.1206,-3
"5162",1,15,2,-13,-17.7094840153458,7.8174,12.8794,-3
"5163",1,18,0,-18,-22.84580111285,12.8174,14.8794,0
"5164",1,25,25,0,-16.9222077172593,-5.1826,-10.1206,7
"5165",1,25,2,-23,-30.7843855018995,17.8174,12.8794,7
"5166",1,18,9,-9,-17.4806754157677,3.8174,5.8794,0
"5167",1,22,12,-10,-21.0433958012261,4.8174,2.8794,4
"5168",1,18,24,6,-8.39850183331293,-11.1826,-9.1206,0
"5169",1,16,12,-4,-13.0797200889533,-1.1826,2.8794,-2
"5170",1,16,14,-2,-12.0031362105367,-3.1826,0.8794,-2
"5171",1,20,21,1,-13.2025749608282,-6.1826,-6.1206,2
"5172",1,21,28,7,-10.004887981665,-12.1826,-13.1206,3
"5173",1,25,7,-18,-27.7956925383596,12.8174,7.8794,7
"5174",1,20,20,0,-13.6988952460787,-5.1826,-5.1206,2
"5175",1,19,22,3,-11.0974480605723,-8.1826,-7.1206,1
"5176",1,13,10,-3,-10.4294941002537,-2.1826,4.8794,-5
"5177",1,14,15,1,-8.86936563680596,-6.1826,-0.1206,-4
"5178",1,16,22,6,-7.14381894996798,-11.1826,-7.1206,-2
"5179",1,15,5,-10,-16.2303457035,4.8174,9.8794,-3
"5180",1,21,17,-4,-16.4973598437427,-1.1826,-2.1206,3
"5181",1,13,8,-5,-11.5998237215157,-0.1826,6.8794,-5
"5182",1,22,4,-18,-25.7721727121773,12.8174,10.8794,4
"5183",1,28,20,-8,-24.0019600047079,2.8174,-5.1206,10
"5184",1,21,16,-5,-17.1297321601959,-0.1826,-1.1206,3
"5185",1,14,7,-7,-13.613629974522,1.8174,7.8794,-4
"5186",1,23,9,-14,-23.9969318633158,8.8174,5.8794,5
"5187",1,27,1,-26,-34.2711087069951,20.8174,13.8794,9
"5188",1,16,16,0,-10.5773835946338,-5.1826,-1.1206,-2
"5189",1,33,20,-13,-30.2517664314842,7.8174,-5.1206,15
"5190",1,23,15,-8,-20.2792152835587,2.8174,-0.1206,5
"5191",1,23,19,-4,-17.9782941510347,-1.1826,-4.1206,5
"5192",1,20,7,-13,-21.3203171303718,7.8174,7.8794,2
"5193",1,18,23,5,-9.04334611988948,-10.1826,-8.1206,0
"5194",1,17,29,12,-4.05655734887536,-17.1826,-14.1206,-1
"5195",1,22,12,-10,-21.1293807256094,4.8174,2.8794,4
"5196",1,31,12,-19,-32.4821813808798,13.8174,2.8794,13
"5197",1,13,3,-10,-14.7554147224559,4.8174,11.8794,-5
"5198",1,18,26,8,-7.32798525428207,-13.1826,-11.1206,0
"5199",1,18,15,-3,-13.8817225373195,-2.1826,-0.1206,0
"5200",1,22,15,-7,-18.8079126041856,1.8174,-0.1206,4
"5201",1,18,27,9,-6.72967890234934,-14.1826,-12.1206,0
"5202",1,23,6,-17,-25.8371346398987,11.8174,8.8794,5
"5203",1,17,3,-14,-19.8933042895764,8.8174,11.8794,-1
"5204",1,15,13,-2,-11.3476321895032,-3.1826,1.8794,-3
"5205",1,9,17,8,-1.21689813623199,-13.1826,-2.1206,-9
"5206",1,22,17,-5,-17.9050091588187,-0.1826,-2.1206,4
"5207",1,19,23,4,-10.5697346180166,-9.1826,-8.1206,1
"5208",1,14,14,0,-9.23455069014552,-5.1826,0.8794,-4
"5209",1,20,15,-5,-16.6176381112117,-0.1826,-0.1206,2
"5210",1,15,14,-1,-10.6811286488428,-4.1826,0.8794,-3
"5211",1,18,11,-7,-16.3828461933541,1.8174,3.8794,0
"5212",1,21,12,-9,-19.4401591374702,3.8174,2.8794,3
"5213",1,18,3,-15,-21.1278484461295,9.8174,11.8794,0
"5214",1,17,6,-11,-17.9692580857915,5.8174,8.8794,-1
"5215",1,18,25,7,-7.86954780157382,-12.1826,-10.1206,0
"5216",1,22,22,0,-14.7146700872709,-5.1826,-7.1206,4
"5217",1,18,3,-15,-21.2229130841627,9.8174,11.8794,0
"5218",1,19,7,-12,-20.1948983636267,6.8174,7.8794,1
"5219",1,22,14,-8,-19.5314324442802,2.8174,0.8794,4
"5220",1,20,12,-8,-18.3302138828808,2.8174,2.8794,2
"5221",1,16,16,0,-10.7784065517191,-5.1826,-1.1206,-2
"5222",1,24,23,-1,-17.2224634457937,-4.1826,-8.1206,6
"5223",1,17,9,-8,-16.1003800165649,2.8174,5.8794,-1
"5224",1,26,13,-13,-25.46449664891,7.8174,1.8794,8
"5225",1,22,25,3,-13.0734340091514,-8.1826,-10.1206,4
"5226",1,16,5,-11,-17.2905804356467,5.8174,9.8794,-2
"5227",1,19,23,4,-10.4052940612873,-9.1826,-8.1206,1
"5228",1,14,2,-12,-16.6540500779136,6.8174,12.8794,-4
"5229",1,15,21,6,-6.34740933661931,-11.1826,-6.1206,-3
"5230",1,18,7,-11,-18.5879777079361,5.8174,7.8794,0
"5231",1,20,15,-5,-16.6093479535961,-0.1826,-0.1206,2
"5232",1,23,21,-2,-16.8543954321123,-3.1826,-6.1206,5
"5233",1,23,18,-5,-18.5563402617479,-0.1826,-3.1206,5
"5234",1,13,1,-12,-15.7292458880824,6.8174,13.8794,-5
"5235",1,22,20,-2,-16.0083639563905,-3.1826,-5.1206,4
"5236",1,23,8,-15,-24.8198705101976,9.8174,6.8794,5
"5237",1,13,19,6,-5.16230081021393,-11.1826,-4.1206,-5
"5238",1,15,9,-6,-13.3385955899555,0.8174,5.8794,-3
"5239",1,17,26,9,-5.86064475435636,-14.1826,-11.1206,-1
"5240",1,22,19,-3,-16.6884152490262,-2.1826,-4.1206,4
"5241",1,23,20,-3,-17.9571465281837,-2.1826,-5.1206,5
"5242",1,15,4,-11,-16.6549776529161,5.8174,10.8794,-3
"5243",1,22,14,-8,-19.5104794314698,2.8174,0.8794,4
"5244",1,22,27,5,-11.9803378218732,-10.1826,-12.1206,4
"5245",1,22,26,4,-12.4676695005483,-9.1826,-11.1206,4
"5246",1,19,18,-1,-13.3292855940971,-4.1826,-3.1206,1
"5247",1,18,29,11,-5.54807606916959,-16.1826,-14.1206,0
"5248",1,22,9,-13,-22.749895863614,7.8174,5.8794,4
"5249",1,24,27,3,-14.3576795363343,-8.1826,-12.1206,6
"5250",1,18,12,-6,-15.5240983792167,0.8174,2.8794,0
"5251",1,25,24,-1,-17.2943604713121,-4.1826,-9.1206,7
"5252",1,15,22,7,-5.73363278176198,-12.1826,-7.1206,-3
"5253",1,21,10,-11,-20.8384210018665,5.8174,4.8794,3
"5254",1,22,2,-20,-26.7070945774018,14.8174,12.8794,4
"5255",1,18,19,1,-11.5852266369386,-6.1826,-4.1206,0
"5256",1,12,30,18,2.90970651921252,-23.1826,-15.1206,-6
"5257",1,19,5,-14,-20.8105527650442,8.8174,9.8794,1
"5258",1,28,14,-14,-27.6383299797866,8.8174,0.8794,10
"5259",1,25,30,5,-14.248276150858,-10.1826,-15.1206,7
"5260",1,16,20,4,-8.44657184094645,-9.1826,-5.1206,-2
"5261",1,17,23,6,-7.74619104922913,-11.1826,-8.1206,-1
"5262",1,28,12,-16,-28.6907968258303,10.8174,2.8794,10
"5263",1,19,14,-5,-15.5986101840539,-0.1826,0.8794,1
"5264",1,16,8,-8,-15.6481891511261,2.8174,6.8794,-2
"5265",1,25,2,-23,-30.9645229028061,17.8174,12.8794,7
"5266",1,14,11,-3,-11.3233856269923,-2.1826,3.8794,-4
"5267",1,22,5,-17,-25.3857745128384,11.8174,9.8794,4
"5268",1,29,9,-20,-31.7536416144542,14.8174,5.8794,11
"5269",1,23,25,2,-14.1168591838936,-7.1826,-10.1206,5
"5270",1,26,24,-2,-18.8881943925071,-3.1826,-9.1206,8
"5271",1,21,24,3,-12.4557724682127,-8.1826,-9.1206,3
"5272",1,21,8,-13,-22.1254391891985,7.8174,6.8794,3
"5273",1,13,2,-11,-15.2135451429706,5.8174,12.8794,-5
"5274",1,16,28,12,-3.44692128812515,-17.1826,-13.1206,-2
"5275",1,21,8,-13,-22.2435281793796,7.8174,6.8794,3
"5276",1,18,0,-18,-22.9911867578844,12.8174,14.8794,0
"5277",1,17,17,0,-11.2655632344922,-5.1826,-2.1206,-1
"5278",1,26,25,-1,-18.3536483787252,-4.1826,-10.1206,8
"5279",1,20,20,0,-13.5115358093537,-5.1826,-5.1206,2
"5280",1,24,30,6,-12.7464790158217,-11.1826,-15.1206,6
"5281",1,8,12,4,-2.597139115652,-9.1826,2.8794,-10
"5282",1,21,5,-16,-23.8041312111198,10.8174,9.8794,3
"5283",1,14,14,0,-9.10538491197759,-5.1826,0.8794,-4
"5284",1,24,3,-21,-28.8095766142393,15.8174,11.8794,6
"5285",1,21,23,2,-12.9404574600494,-7.1826,-8.1206,3
"5286",1,17,6,-11,-17.7975902048712,5.8174,8.8794,-1
"5287",1,22,22,0,-14.7928734462006,-5.1826,-7.1206,4
"5288",1,21,28,7,-10.1632321920245,-12.1826,-13.1206,3
"5289",1,21,8,-13,-22.0840334924924,7.8174,6.8794,3
"5290",1,19,13,-6,-16.5310153918329,0.8174,1.8794,1
"5291",1,16,7,-9,-16.2542538825324,3.8174,7.8794,-2
"5292",1,9,1,-8,-10.3565495296065,2.8174,13.8794,-9
"5293",1,13,19,6,-5.0742235806166,-11.1826,-4.1206,-5
"5294",1,17,14,-3,-13.4145995254431,-2.1826,0.8794,-1
"5295",1,28,17,-11,-25.5088178205226,5.8174,-2.1206,10
"5296",1,15,13,-2,-11.0438053954779,-3.1826,1.8794,-3
"5297",1,18,22,4,-9.63851798574478,-9.1826,-7.1206,0
"5298",1,23,3,-20,-27.5293726492473,14.8174,11.8794,5
"5299",1,18,27,9,-6.80987662853115,-14.1826,-12.1206,0
"5300",1,17,30,13,-3.66634128513862,-18.1826,-15.1206,-1
"5301",1,28,4,-24,-33.4887874277284,18.8174,10.8794,10
"5302",1,18,2,-16,-21.6910401428654,10.8174,12.8794,0
"5303",1,18,6,-12,-19.2994805006045,6.8174,8.8794,0
"5304",1,18,24,6,-8.50638829874745,-11.1826,-9.1206,0
"5305",1,19,12,-7,-17.3633892068088,1.8174,2.8794,1
"5306",1,23,27,4,-13.1048406824494,-9.1826,-12.1206,5
"5307",1,20,7,-13,-21.6209848218455,7.8174,7.8794,2
"5308",1,24,16,-8,-20.9525662702124,2.8174,-1.1206,6
"5309",1,9,3,-6,-9.91060855989957,0.8174,11.8794,-9
"5310",1,18,28,10,-5.92547824138229,-15.1826,-13.1206,0
"5311",1,21,22,1,-13.3807251287657,-6.1826,-7.1206,3
"5312",1,25,0,-25,-31.7648868991946,19.8174,14.8794,7
"5313",1,21,17,-4,-16.6520748340909,-1.1826,-2.1206,3
"5314",1,19,25,6,-9.18456810779928,-11.1826,-10.1206,1
"5315",1,22,30,8,-10.0497076141366,-13.1826,-15.1206,4
"5316",1,22,24,2,-13.968609362439,-7.1826,-9.1206,4
"5317",1,15,10,-5,-13.1604548999901,-0.1826,4.8794,-3
"5318",1,21,11,-10,-20.1627236187734,4.8174,3.8794,3
"5319",1,18,28,10,-5.77494825067068,-15.1826,-13.1206,0
"5320",1,17,21,4,-8.97568785121144,-9.1826,-6.1206,-1
"5321",1,21,11,-10,-20.4860499052587,4.8174,3.8794,3
"5322",1,18,0,-18,-22.8522712770239,12.8174,14.8794,0
"5323",1,24,30,6,-12.683890113538,-11.1826,-15.1206,6
"5324",1,25,24,-1,-17.8232632292635,-4.1826,-9.1206,7
"5325",1,24,7,-17,-26.5850124713125,11.8174,7.8794,6
"5326",1,18,30,12,-4.88165560665651,-17.1826,-15.1206,0
"5327",1,15,11,-4,-12.421831676011,-1.1826,3.8794,-3
"5328",1,16,23,7,-6.35010179717937,-12.1826,-8.1206,-2
"5329",1,21,14,-7,-18.3910895832837,1.8174,0.8794,3
"5330",1,24,28,4,-13.8676499408539,-9.1826,-13.1206,6
"5331",1,17,14,-3,-13.2237854556506,-2.1826,0.8794,-1
"5332",1,16,27,11,-4.08252263636247,-16.1826,-12.1206,-2
"5333",1,13,5,-8,-13.420968328056,2.8174,9.8794,-5
"5334",1,17,15,-2,-12.6258877913268,-3.1826,-0.1206,-1
"5335",1,22,14,-8,-20.0455800687773,2.8174,0.8794,4
"5336",1,13,10,-3,-10.4872730645712,-2.1826,4.8794,-5
"5337",1,18,9,-9,-17.4401768862391,3.8174,5.8794,0
"5338",1,29,23,-6,-23.3306115380551,0.8174,-8.1206,11
"5339",1,21,12,-9,-19.5278901083716,3.8174,2.8794,3
"5340",1,25,7,-18,-27.7557243049021,12.8174,7.8794,7
"5341",1,17,15,-2,-12.6061618383703,-3.1826,-0.1206,-1
"5342",1,26,15,-11,-24.4421713590369,5.8174,-0.1206,8
"5343",1,19,19,0,-12.6640714954346,-5.1826,-4.1206,1
"5344",1,19,10,-9,-18.3036759697117,3.8174,4.8794,1
"5345",1,22,19,-3,-16.9837729973413,-2.1826,-4.1206,4
"5346",1,14,13,-1,-9.9649248171275,-4.1826,1.8794,-4
"5347",1,24,17,-7,-20.5703055727309,1.8174,-2.1206,6
"5348",1,17,11,-6,-14.9607631777997,0.8174,3.8794,-1
"5349",1,22,17,-5,-18.0518188151894,-0.1826,-2.1206,4
"5350",1,14,24,10,-3.02079235262732,-15.1826,-9.1206,-4
"5351",1,24,23,-1,-16.5558463392564,-4.1826,-8.1206,6
"5352",1,12,14,2,-6.73041828594437,-7.1826,0.8794,-6
"5353",1,12,10,-2,-9.09033555898195,-3.1826,4.8794,-6
"5354",1,25,16,-9,-22.4203465391684,3.8174,-1.1206,7
"5355",1,14,15,1,-8.48780471880214,-6.1826,-0.1206,-4
"5356",1,19,8,-11,-19.6891524411506,5.8174,6.8794,1
"5357",1,19,14,-5,-15.509999830739,-0.1826,0.8794,1
"5358",1,21,1,-20,-26.3012566172439,14.8174,13.8794,3
"5359",1,15,3,-12,-17.215791033927,6.8174,11.8794,-3
"5360",1,27,2,-25,-33.6194608219153,19.8174,12.8794,9
"5361",1,21,7,-14,-22.7334112163952,8.8174,7.8794,3
"5362",1,26,12,-14,-26.2102223172152,8.8174,2.8794,8
"5363",1,28,10,-18,-30.0745670872925,12.8174,4.8794,10
"5364",1,17,24,7,-7.09189064029843,-12.1826,-9.1206,-1
"5365",1,19,25,6,-9.08200699728362,-11.1826,-10.1206,1
"5366",1,27,2,-25,-33.154883951672,19.8174,12.8794,9
"5367",1,15,12,-3,-11.7444247423152,-2.1826,2.8794,-3
"5368",1,16,12,-4,-13.1198280064216,-1.1826,2.8794,-2
"5369",1,20,23,3,-11.6938245806901,-8.1826,-8.1206,2
"5370",1,22,2,-20,-26.8524263881502,14.8174,12.8794,4
"5371",1,15,14,-1,-10.5580771487922,-4.1826,0.8794,-3
"5372",1,21,28,7,-10.0375774028071,-12.1826,-13.1206,3
"5373",1,22,3,-19,-26.0591170528612,13.8174,11.8794,4
"5374",1,18,28,10,-6.36268869899982,-15.1826,-13.1206,0
"5375",1,15,15,0,-10.040028242433,-5.1826,-0.1206,-3
"5376",1,16,3,-13,-18.518002712886,7.8174,11.8794,-2
"5377",1,20,5,-15,-22.7310841481969,9.8174,9.8794,2
"5378",1,20,12,-8,-18.3468782598731,2.8174,2.8794,2
"5379",1,17,22,5,-8.37017120400621,-10.1826,-7.1206,-1
"5380",1,25,27,2,-15.6958391822778,-7.1826,-12.1206,7
"5381",1,21,19,-2,-15.7052664398476,-3.1826,-4.1206,3
"5382",1,11,28,17,3.21376758026862,-22.1826,-13.1206,-7
"5383",1,26,27,1,-17.2104057530297,-6.1826,-12.1206,8
"5384",1,8,24,16,4.64254642873892,-21.1826,-9.1206,-10
"5385",1,20,25,5,-10.5631584064368,-10.1826,-10.1206,2
"5386",1,18,20,2,-10.9373524106021,-7.1826,-5.1206,0
"5387",1,19,15,-4,-15.171772121939,-1.1826,-0.1206,1
"5388",1,25,20,-5,-20.0144018130741,-0.1826,-5.1206,7
"5389",1,12,22,10,-2.14213278290189,-15.1826,-7.1206,-6
"5390",1,17,12,-5,-14.4242929690921,-0.1826,2.8794,-1
"5391",1,25,1,-24,-31.3534936887819,18.8174,13.8794,7
"5392",1,23,28,5,-12.6640218954942,-10.1826,-13.1206,5
"5393",1,23,7,-16,-25.1348831254088,10.8174,7.8794,5
"5394",1,16,11,-5,-13.6127692042443,-0.1826,3.8794,-2
"5395",1,29,13,-16,-29.499402348641,10.8174,1.8794,11
"5396",1,18,8,-10,-17.9761302126296,4.8174,6.8794,0
"5397",1,22,24,2,-13.5013934412178,-7.1826,-9.1206,4
"5398",1,22,24,2,-13.6309250586243,-7.1826,-9.1206,4
"5399",1,25,18,-7,-21.231003208362,1.8174,-3.1206,7
"5400",1,20,27,7,-9.33749691181411,-12.1826,-12.1206,2
"5401",1,11,2,-9,-12.5001152108882,3.8174,12.8794,-7
"5402",1,20,25,5,-10.2579331998131,-10.1826,-10.1206,2
"5403",1,13,12,-1,-9.04536663987452,-4.1826,2.8794,-5
"5404",1,21,1,-20,-26.3604393530065,14.8174,13.8794,3
"5405",1,16,14,-2,-11.7903518671211,-3.1826,0.8794,-2
"5406",1,23,28,5,-12.6839946978051,-10.1826,-13.1206,5
"5407",1,11,15,4,-4.8659328669207,-9.1826,-0.1206,-7
"5408",1,23,1,-22,-28.844281667174,16.8174,13.8794,5
"5409",1,19,19,0,-12.8219197686681,-5.1826,-4.1206,1
"5410",1,14,5,-9,-14.6162374025057,3.8174,9.8794,-4
"5411",1,21,11,-10,-20.2690566280945,4.8174,3.8794,3
"5412",1,17,11,-6,-14.8860874135863,0.8174,3.8794,-1
"5413",1,21,29,8,-9.39466151586698,-13.1826,-14.1206,3
"5414",1,21,15,-6,-17.8077850837129,0.8174,-0.1206,3
"5415",1,30,16,-14,-28.7458203161998,8.8174,-1.1206,12
"5416",1,16,20,4,-8.2399876720473,-9.1826,-5.1206,-2
"5417",1,19,13,-6,-16.3130187848422,0.8174,1.8794,1
"5418",1,15,15,0,-9.85682829941264,-5.1826,-0.1206,-3
"5419",1,23,9,-14,-24.0262229475997,8.8174,5.8794,5
"5420",1,18,20,2,-11.2995042546553,-7.1826,-5.1206,0
"5421",1,18,17,-1,-12.5918266660157,-4.1826,-2.1206,0
"5422",1,21,20,-1,-15.153805275798,-4.1826,-5.1206,3
"5423",1,18,12,-6,-15.5716539260602,0.8174,2.8794,0
"5424",1,14,26,12,-2.18838330750764,-17.1826,-11.1206,-4
"5425",1,22,20,-2,-16.2688045887344,-3.1826,-5.1206,4
"5426",1,23,2,-21,-28.1553453679362,15.8174,12.8794,5
"5427",1,24,9,-15,-25.0468105620294,9.8174,5.8794,6
"5428",1,21,3,-18,-24.8906615602129,12.8174,11.8794,3
"5429",1,19,2,-17,-23.2246068042757,11.8174,12.8794,1
"5430",1,26,10,-16,-27.4255943883302,10.8174,4.8794,8
"5431",1,22,17,-5,-17.9932613484348,-0.1826,-2.1206,4
"5432",1,17,22,5,-8.45710004149715,-10.1826,-7.1206,-1
"5433",1,21,29,8,-9.29360555382298,-13.1826,-14.1206,3
"5434",1,16,13,-3,-12.2877814905198,-2.1826,1.8794,-2
"5435",1,18,12,-6,-15.7810324943415,0.8174,2.8794,0
"5436",1,18,19,1,-11.3969539866677,-6.1826,-4.1206,0
"5437",1,23,19,-4,-17.940851746707,-1.1826,-4.1206,5
"5438",1,14,24,10,-3.25844174508386,-15.1826,-9.1206,-4
"5439",1,20,27,7,-9.15774666445772,-12.1826,-12.1206,2
"5440",1,25,6,-19,-28.3851660042381,13.8174,8.8794,7
"5441",1,23,28,5,-12.5470475596076,-10.1826,-13.1206,5
"5442",1,18,28,10,-6.1490796669548,-15.1826,-13.1206,0
"5443",1,23,17,-6,-19.1437906585501,0.8174,-2.1206,5
"5444",1,21,3,-18,-25.0756328188947,12.8174,11.8794,3
"5445",1,16,20,4,-8.37670020723876,-9.1826,-5.1206,-2
"5446",1,22,13,-9,-20.5103438625405,3.8174,1.8794,4
"5447",1,23,4,-19,-27.0315322549257,13.8174,10.8794,5
"5448",1,19,10,-9,-18.2435303762931,3.8174,4.8794,1
"5449",1,19,17,-2,-14.0035125952509,-3.1826,-2.1206,1
"5450",1,16,15,-1,-11.2018197606827,-4.1826,-0.1206,-2
"5451",1,13,12,-1,-9.10823194429422,-4.1826,2.8794,-5
"5452",1,15,25,10,-4.14424176800344,-15.1826,-10.1206,-3
"5453",1,23,30,7,-11.6257917653691,-12.1826,-15.1206,5
"5454",1,27,26,-1,-18.9508714540253,-4.1826,-11.1206,9
"5455",1,28,16,-12,-26.4529315294612,6.8174,-1.1206,10
"5456",1,16,1,-15,-19.7303627898185,9.8174,13.8794,-2
"5457",1,15,27,12,-3.02834647927424,-17.1826,-12.1206,-3
"5458",1,26,11,-15,-26.5441415971546,9.8174,3.8794,8
"5459",1,30,2,-28,-37.2655827994003,22.8174,12.8794,12
"5460",1,21,21,0,-14.0351081028932,-5.1826,-6.1206,3
"5461",1,28,22,-6,-22.6917290936062,0.8174,-7.1206,10
"5462",1,20,21,1,-12.9101253464907,-6.1826,-6.1206,2
"5463",1,13,13,0,-8.65920580199476,-5.1826,1.8794,-5
"5464",1,19,6,-13,-20.6912652853323,7.8174,8.8794,1
"5465",1,19,18,-1,-13.3272258113728,-4.1826,-3.1206,1
"5466",1,16,19,3,-8.63777205123878,-8.1826,-4.1206,-2
"5467",1,20,16,-4,-15.8044691617408,-1.1826,-1.1206,2
"5468",1,16,28,12,-3.59422003460655,-17.1826,-13.1206,-2
"5469",1,18,22,4,-9.66460484428153,-9.1826,-7.1206,0
"5470",1,17,15,-2,-12.6667855465074,-3.1826,-0.1206,-1
"5471",1,25,28,3,-15.1749685604409,-8.1826,-13.1206,7
"5472",1,17,15,-2,-12.7166547332571,-3.1826,-0.1206,-1
"5473",1,14,12,-2,-10.4984985987138,-3.1826,2.8794,-4
"5474",1,28,10,-18,-30.000335859949,12.8174,4.8794,10
"5475",1,24,28,4,-13.9559121686564,-9.1826,-13.1206,6
"5476",1,28,29,1,-18.6817478036204,-6.1826,-14.1206,10
"5477",1,21,14,-7,-18.1512205387256,1.8174,0.8794,3
"5478",1,20,12,-8,-18.2957748273416,2.8174,2.8794,2
"5479",1,15,18,3,-8.62348511438691,-8.1826,-3.1206,-3
"5480",1,20,19,-1,-14.0490549609254,-4.1826,-4.1206,2
"5481",1,30,26,-4,-23.090555937773,-1.1826,-11.1206,12
"5482",1,25,26,1,-16.3297048844115,-6.1826,-11.1206,7
"5483",1,19,17,-2,-14.0054230241007,-3.1826,-2.1206,1
"5484",1,18,6,-12,-19.1766187903534,6.8174,8.8794,0
"5485",1,11,23,12,-0.138133154116068,-17.1826,-8.1206,-7
"5486",1,21,19,-2,-15.4401935761917,-3.1826,-4.1206,3
"5487",1,23,19,-4,-18.0407099248316,-1.1826,-4.1206,5
"5488",1,17,17,0,-11.3788285477894,-5.1826,-2.1206,-1
"5489",1,20,30,10,-7.81830873210092,-15.1826,-15.1206,2
"5490",1,19,8,-11,-19.1858349520928,5.8174,6.8794,1
"5491",1,13,28,15,0.378827635927658,-20.1826,-13.1206,-5
"5492",1,17,10,-7,-15.6605786345057,1.8174,4.8794,-1
"5493",1,23,30,7,-11.4854844012815,-12.1826,-15.1206,5
"5494",1,11,17,6,-3.63057037385025,-11.1826,-2.1206,-7
"5495",1,19,1,-18,-23.4409566844574,12.8174,13.8794,1
"5496",1,20,28,8,-8.74709684801381,-13.1826,-13.1206,2
"5497",1,22,17,-5,-17.8752285127521,-0.1826,-2.1206,4
"5498",1,25,3,-22,-30.2169348687737,16.8174,11.8794,7
"5499",1,24,13,-11,-22.8824495495425,5.8174,1.8794,6
"5500",1,19,23,4,-10.4967848359025,-9.1826,-8.1206,1
"5501",1,20,27,7,-9.38891200259073,-12.1826,-12.1206,2
"5502",1,10,15,5,-3.54700990281591,-10.1826,-0.1206,-8
"5503",1,22,6,-16,-24.4404358507462,10.8174,8.8794,4
"5504",1,20,22,2,-12.2051123058911,-7.1826,-7.1206,2
"5505",1,15,7,-8,-14.6473301849886,2.8174,7.8794,-3
"5506",1,19,16,-3,-14.845918276414,-2.1826,-1.1206,1
"5507",1,24,23,-1,-16.9069796517724,-4.1826,-8.1206,6
"5508",1,17,26,9,-6.03852895173189,-14.1826,-11.1206,-1
"5509",1,15,17,2,-8.83196732384784,-7.1826,-2.1206,-3
"5510",1,21,19,-2,-15.4510633741318,-3.1826,-4.1206,3
"5511",1,14,20,6,-5.80970267261707,-11.1826,-5.1206,-4
"5512",1,22,15,-7,-19.2347297949249,1.8174,-0.1206,4
"5513",1,11,29,18,3.72070614760084,-23.1826,-14.1206,-7
"5514",1,21,28,7,-9.99131644083782,-12.1826,-13.1206,3
"5515",1,20,1,-19,-24.8744476477654,13.8174,13.8794,2
"5516",1,16,15,-1,-11.4246054022299,-4.1826,-0.1206,-2
"5517",1,23,12,-11,-22.193828027926,5.8174,2.8794,5
"5518",1,24,19,-5,-19.3868188874251,-0.1826,-4.1206,6
"5519",1,25,1,-24,-31.2831246654957,18.8174,13.8794,7
"5520",1,24,0,-24,-30.5728152775655,18.8174,14.8794,6
"5521",1,20,28,8,-8.82575245925833,-13.1826,-13.1206,2
"5522",1,15,6,-9,-15.3822817989835,3.8174,8.8794,-3
"5523",1,25,9,-16,-27.0318351055892,10.8174,5.8794,7
"5524",1,13,1,-12,-15.9764105828337,6.8174,13.8794,-5
"5525",1,30,27,-3,-22.4898444922155,-2.1826,-12.1206,12
"5526",1,16,21,5,-7.66043978168608,-10.1826,-6.1206,-2
"5527",1,24,20,-4,-18.6313894749155,-1.1826,-5.1206,6
"5528",1,29,13,-16,-29.5067613862205,10.8174,1.8794,11
"5529",1,20,2,-18,-24.2931112643047,12.8174,12.8794,2
"5530",1,18,19,1,-11.3728921206943,-6.1826,-4.1206,0
"5531",1,19,7,-12,-19.7544898681265,6.8174,7.8794,1
"5532",1,26,4,-22,-30.774388695154,16.8174,10.8794,8
"5533",1,25,19,-6,-20.6241171603958,0.8174,-4.1206,7
"5534",1,12,20,8,-2.85323923219512,-13.1826,-5.1206,-6
"5535",1,20,29,9,-7.89192925963194,-14.1826,-14.1206,2
"5536",1,22,16,-6,-18.3651911129645,0.8174,-1.1206,4
"5537",1,18,9,-9,-17.5718961055766,3.8174,5.8794,0
"5538",1,12,6,-6,-11.3242523515826,0.8174,8.8794,-6
"5539",1,14,1,-13,-17.1693345279068,7.8174,13.8794,-4
"5540",1,17,21,4,-8.78901253087345,-9.1826,-6.1206,-1
"5541",1,23,18,-5,-18.6107079473326,-0.1826,-3.1206,5
"5542",1,19,13,-6,-16.5352275768305,0.8174,1.8794,1
"5543",1,16,6,-10,-16.7145258114141,4.8174,8.8794,-2
"5544",1,17,8,-9,-16.8304296948578,3.8174,6.8794,-1
"5545",1,21,16,-5,-17.1415681659201,-0.1826,-1.1206,3
"5546",1,14,16,2,-8.10883151965451,-7.1826,-1.1206,-4
"5547",1,17,2,-15,-20.2444606958886,9.8174,12.8794,-1
"5548",1,20,4,-16,-22.9372009747871,10.8174,10.8794,2
"5549",1,20,15,-5,-16.6928927677368,-0.1826,-0.1206,2
"5550",1,12,25,13,0.00594329106134514,-18.1826,-10.1206,-6
"5551",1,17,22,5,-8.33001760824107,-10.1826,-7.1206,-1
"5552",1,19,19,0,-12.8086480266506,-5.1826,-4.1206,1
"5553",1,14,11,-3,-11.308193379873,-2.1826,3.8794,-4
"5554",1,19,9,-10,-18.5539910872222,4.8174,5.8794,1
"5555",1,25,23,-2,-18.1758306147788,-3.1826,-8.1206,7
"5556",1,20,5,-15,-22.5767078575164,9.8174,9.8794,2
"5557",1,23,6,-17,-25.6194989747479,11.8174,8.8794,5
"5558",1,15,25,10,-4.16351200711471,-15.1826,-10.1206,-3
"5559",1,16,15,-1,-11.250396349992,-4.1826,-0.1206,-2
"5560",1,21,19,-2,-15.3008494441981,-3.1826,-4.1206,3
"5561",1,17,7,-10,-17.39190691281,4.8174,7.8794,-1
"5562",1,18,12,-6,-15.7644245267646,0.8174,2.8794,0
"5563",1,11,4,-7,-11.5564035098287,1.8174,10.8794,-7
"5564",1,17,9,-8,-16.2958724453561,2.8174,5.8794,-1
"5565",1,19,1,-18,-23.5076173530412,12.8174,13.8794,1
"5566",1,18,4,-14,-20.4312931983959,8.8174,10.8794,0
"5567",1,26,9,-17,-27.9536665894649,11.8174,5.8794,8
"5568",1,21,24,3,-12.4425207456059,-8.1826,-9.1206,3
"5569",1,17,3,-14,-19.7310244549222,8.8174,11.8794,-1
"5570",1,28,19,-9,-24.5298248604423,3.8174,-4.1206,10
"5571",1,25,1,-24,-31.4243730897087,18.8174,13.8794,7
"5572",1,26,16,-10,-23.646099238539,4.8174,-1.1206,8
"5573",1,20,8,-12,-20.7729738111488,6.8174,6.8794,2
"5574",1,16,6,-10,-16.8963278451679,4.8174,8.8794,-2
"5575",1,17,19,2,-10.030655804385,-7.1826,-4.1206,-1
"5576",1,28,0,-28,-35.6332987367344,22.8174,14.8794,10
"5577",1,18,10,-8,-16.9479295089774,2.8174,4.8794,0
"5578",1,24,8,-16,-25.8766795599775,10.8174,6.8794,6
"5579",1,15,16,1,-9.24246423912945,-6.1826,-1.1206,-3
"5580",1,22,29,7,-10.6910455657315,-12.1826,-14.1206,4
"5581",1,23,3,-20,-27.5402736986092,14.8174,11.8794,5
"5582",1,18,6,-12,-19.1947078198659,6.8174,8.8794,0
"5583",1,16,25,9,-5.06474324978591,-14.1826,-10.1206,-2
"5584",1,18,10,-8,-16.6421653301659,2.8174,4.8794,0
"5585",1,23,26,3,-14.0279096742174,-8.1826,-11.1206,5
"5586",1,16,21,5,-7.81297570489676,-10.1826,-6.1206,-2
"5587",1,20,22,2,-12.4169101692778,-7.1826,-7.1206,2
"5588",1,15,0,-15,-19.1520092067618,9.8174,14.8794,-3
"5589",1,16,21,5,-7.58697190482963,-10.1826,-6.1206,-2
"5590",1,23,15,-8,-20.3277193798854,2.8174,-0.1206,5
"5591",1,15,19,4,-7.83436931636787,-9.1826,-4.1206,-3
"5592",1,24,8,-16,-25.8020322919237,10.8174,6.8794,6
"5593",1,19,5,-14,-21.2623127479051,8.8174,9.8794,1
"5594",1,19,1,-18,-23.5948618002831,12.8174,13.8794,1
"5595",1,22,15,-7,-19.1406268727082,1.8174,-0.1206,4
"5596",1,23,13,-10,-21.8150255523205,4.8174,1.8794,5
"5597",1,16,18,2,-9.21650631488458,-7.1826,-3.1206,-2
"5598",1,13,16,3,-6.80957630562619,-8.1826,-1.1206,-5
"5599",1,15,23,8,-5.01894868785485,-13.1826,-8.1206,-3
"5600",1,22,11,-11,-21.5630430674429,5.8174,3.8794,4
"5601",1,20,1,-19,-24.8280199234732,13.8174,13.8794,2
"5602",1,22,30,8,-10.1097790817444,-13.1826,-15.1206,4
"5603",1,25,27,2,-15.8259607005506,-7.1826,-12.1206,7
"5604",1,17,9,-8,-16.1492759935349,2.8174,5.8794,-1
"5605",1,19,1,-18,-23.261939749168,12.8174,13.8794,1
"5606",1,27,9,-18,-28.9964010083687,12.8174,5.8794,9
"5607",1,24,21,-3,-18.1092166741854,-2.1826,-6.1206,6
"5608",1,17,12,-5,-14.3557763887658,-0.1826,2.8794,-1
"5609",1,17,19,2,-10.5289791584776,-7.1826,-4.1206,-1
"5610",1,14,8,-6,-12.7825167013359,0.8174,6.8794,-4
"5611",1,27,10,-17,-28.8910329162904,11.8174,4.8794,9
"5612",1,22,14,-8,-19.7339376575153,2.8174,0.8794,4
"5613",1,16,3,-13,-18.3197518420375,7.8174,11.8794,-2
"5614",1,18,22,4,-9.65813139488625,-9.1826,-7.1206,0
"5615",1,16,10,-6,-14.5414861355385,0.8174,4.8794,-2
"5616",1,20,9,-11,-20.3965591547289,5.8174,5.8794,2
"5617",1,18,15,-3,-13.8546290045396,-2.1826,-0.1206,0
"5618",1,30,6,-24,-35.078853168135,18.8174,8.8794,12
"5619",1,20,25,5,-10.5505944544582,-10.1826,-10.1206,2
"5620",1,20,17,-3,-15.2489071477949,-2.1826,-2.1206,2
"5621",1,19,3,-16,-22.1322666179429,10.8174,11.8794,1
"5622",1,22,5,-17,-24.7613362760939,11.8174,9.8794,4
"5623",1,21,2,-19,-25.6606540083402,13.8174,12.8794,3
"5624",1,21,23,2,-13.1056617644932,-7.1826,-8.1206,3
"5625",1,15,22,7,-5.74039636472662,-12.1826,-7.1206,-3
"5626",1,20,13,-7,-17.9387269444148,1.8174,1.8794,2
"5627",1,20,20,0,-13.8335910963676,-5.1826,-5.1206,2
"5628",1,18,10,-8,-16.8346988849467,2.8174,4.8794,0
"5629",1,23,6,-17,-25.773167451024,11.8174,8.8794,5
"5630",1,19,26,7,-8.89860152451108,-12.1826,-11.1206,1
"5631",1,18,11,-7,-16.2450960683683,1.8174,3.8794,0
"5632",1,22,0,-22,-28.1413566939069,16.8174,14.8794,4
"5633",1,24,8,-16,-26.0312610777972,10.8174,6.8794,6
"5634",1,20,27,7,-9.11593853512299,-12.1826,-12.1206,2
"5635",1,19,26,7,-8.80752441810882,-12.1826,-11.1206,1
"5636",1,21,20,-1,-14.4688153760739,-4.1826,-5.1206,3
"5637",1,18,2,-16,-21.4645480660337,10.8174,12.8794,0
"5638",1,25,17,-8,-21.9392070491855,2.8174,-2.1206,7
"5639",1,20,21,1,-12.772090052651,-6.1826,-6.1206,2
"5640",1,15,2,-13,-18.11163971443,7.8174,12.8794,-3
"5641",1,21,0,-21,-26.735104414738,15.8174,14.8794,3
"5642",1,24,22,-2,-17.3568224251266,-3.1826,-7.1206,6
"5643",1,24,3,-21,-28.7573839967655,15.8174,11.8794,6
"5644",1,19,25,6,-9.01677148511568,-11.1826,-10.1206,1
"5645",1,18,14,-4,-14.9164271553307,-1.1826,0.8794,0
"5646",1,20,11,-9,-19.2260680259066,3.8174,3.8794,2
"5647",1,29,28,-1,-20.7994684930434,-4.1826,-13.1206,11
"5648",1,19,5,-14,-21.3220259454877,8.8174,9.8794,1
"5649",1,19,24,5,-9.81480506453392,-10.1826,-9.1206,1
"5650",1,24,21,-3,-18.0288641189844,-2.1826,-6.1206,6
"5651",1,18,4,-14,-20.3687150650632,8.8174,10.8794,0
"5652",1,22,13,-9,-20.3406858146907,3.8174,1.8794,4
"5653",1,20,8,-12,-20.7361329542723,6.8174,6.8794,2
"5654",1,24,25,1,-15.7038898361707,-6.1826,-10.1206,6
"5655",1,20,11,-9,-18.8652632927173,3.8174,3.8794,2
"5656",1,18,12,-6,-15.5678429010145,0.8174,2.8794,0
"5657",1,11,12,1,-6.5377293180161,-6.1826,2.8794,-7
"5658",1,27,17,-10,-24.4888285254088,4.8174,-2.1206,9
"5659",1,21,29,8,-9.52782526572758,-13.1826,-14.1206,3
"5660",1,17,12,-5,-14.6863173803136,-0.1826,2.8794,-1
"5661",1,18,11,-7,-16.3445435943426,1.8174,3.8794,0
"5662",1,22,20,-2,-16.0538922129561,-3.1826,-5.1206,4
"5663",1,23,2,-21,-28.3282660393476,15.8174,12.8794,5
"5664",1,20,13,-7,-17.9219360212028,1.8174,1.8794,2
"5665",1,22,3,-19,-26.2723929249472,13.8174,11.8794,4
"5666",1,12,9,-3,-9.68706823853314,-2.1826,5.8794,-6
"5667",1,28,0,-28,-35.9299683915122,22.8174,14.8794,10
"5668",1,21,16,-5,-17.3819346241762,-0.1826,-1.1206,3
"5669",1,21,29,8,-9.23541804747502,-13.1826,-14.1206,3
"5670",1,25,1,-24,-31.4835566140611,18.8174,13.8794,7
"5671",1,15,0,-15,-19.0773383038889,9.8174,14.8794,-3
"5672",1,25,29,4,-14.7601573817394,-9.1826,-14.1206,7
"5673",1,25,9,-16,-26.6316393018984,10.8174,5.8794,7
"5674",1,22,6,-16,-24.6393170064922,10.8174,8.8794,4
"5675",1,19,1,-18,-23.5987778942596,12.8174,13.8794,1
"5676",1,20,1,-19,-25.0988038970582,13.8174,13.8794,2
"5677",1,15,13,-2,-11.3597227721259,-3.1826,1.8794,-3
"5678",1,20,22,2,-12.3535197221316,-7.1826,-7.1206,2
"5679",1,19,30,11,-6.11743640213073,-16.1826,-15.1206,1
"5680",1,21,6,-15,-23.1295598626087,9.8174,8.8794,3
"5681",1,24,18,-6,-19.9148881726972,0.8174,-3.1206,6
"5682",1,17,13,-4,-13.6751114562169,-1.1826,1.8794,-1
"5683",1,21,8,-13,-21.882218384408,7.8174,6.8794,3
"5684",1,19,12,-7,-16.9749250350146,1.8174,2.8794,1
"5685",1,23,21,-2,-16.9106428779251,-3.1826,-6.1206,5
"5686",1,17,13,-4,-13.9607013629939,-1.1826,1.8794,-1
"5687",1,12,3,-9,-13.1423182808361,3.8174,11.8794,-6
"5688",1,17,1,-16,-20.8165157546378,10.8174,13.8794,-1
"5689",1,19,26,7,-8.82273953302795,-12.1826,-11.1206,1
"5690",1,17,6,-11,-17.7441156616996,5.8174,8.8794,-1
"5691",1,27,28,1,-17.6685070645312,-6.1826,-13.1206,9
"5692",1,22,8,-14,-23.2125067969702,8.8174,6.8794,4
"5693",1,21,18,-3,-15.9871271145426,-2.1826,-3.1206,3
"5694",1,25,14,-11,-23.887687312491,5.8174,0.8794,7
"5695",1,14,19,5,-6.25815441337851,-10.1826,-4.1206,-4
"5696",1,24,12,-12,-23.6740092555816,6.8174,2.8794,6
"5697",1,19,17,-2,-13.9801624149837,-3.1826,-2.1206,1
"5698",1,20,17,-3,-15.2459497146198,-2.1826,-2.1206,2
"5699",1,20,14,-6,-17.2134278166642,0.8174,0.8794,2
"5700",1,12,1,-11,-14.5303362745231,5.8174,13.8794,-6
"5701",1,19,21,2,-11.3528970221157,-7.1826,-6.1206,1
"5702",1,21,1,-20,-26.1130526372024,14.8174,13.8794,3
"5703",1,19,28,9,-7.17894551023775,-14.1826,-13.1206,1
"5704",1,19,14,-5,-15.5361499563864,-0.1826,0.8794,1
"5705",1,13,4,-9,-14.0929827134298,3.8174,10.8794,-5
"5706",1,16,25,9,-5.26442745594802,-14.1826,-10.1206,-2
"5707",1,9,16,7,-1.51947389920305,-12.1826,-1.1206,-9
"5708",1,20,4,-16,-23.0901663121442,10.8174,10.8794,2
"5709",1,18,0,-18,-23.0014531049989,12.8174,14.8794,0
"5710",1,24,20,-4,-18.7381213483031,-1.1826,-5.1206,6
"5711",1,18,5,-13,-19.9512328978486,7.8174,9.8794,0
"5712",1,17,23,6,-7.62972437292967,-11.1826,-8.1206,-1
"5713",1,16,12,-4,-13.1324713537888,-1.1826,2.8794,-2
"5714",1,21,19,-2,-15.2141415678782,-3.1826,-4.1206,3
"5715",1,18,26,8,-7.33520708863591,-13.1826,-11.1206,0
"5716",1,22,22,0,-14.9546162532088,-5.1826,-7.1206,4
"5717",1,26,13,-13,-25.4540854209951,7.8174,1.8794,8
"5718",1,12,4,-8,-12.708301925228,2.8174,10.8794,-6
"5719",1,24,29,5,-13.2327200272678,-10.1826,-14.1206,6
"5720",1,16,3,-13,-18.3890438287738,7.8174,11.8794,-2
"5721",1,24,6,-18,-26.8752823858913,12.8174,8.8794,6
"5722",1,18,21,3,-10.5635060314369,-8.1826,-6.1206,0
"5723",1,17,7,-10,-17.3598722957147,4.8174,7.8794,-1
"5724",1,18,16,-2,-13.4612375019139,-3.1826,-1.1206,0
"5725",1,23,21,-2,-16.7120611287754,-3.1826,-6.1206,5
"5726",1,15,4,-11,-16.4524826142129,5.8174,10.8794,-3
"5727",1,18,20,2,-11.0862520729247,-7.1826,-5.1206,0
"5728",1,18,21,3,-10.269126552468,-8.1826,-6.1206,0
"5729",1,18,30,12,-4.65831671619709,-17.1826,-15.1206,0
"5730",1,14,27,13,-1.57519033752841,-18.1826,-12.1206,-4
"5731",1,19,1,-18,-23.7360779221376,12.8174,13.8794,1
"5732",1,22,1,-21,-27.5747083817016,15.8174,13.8794,4
"5733",1,18,5,-13,-20.013321315634,7.8174,9.8794,0
"5734",1,17,22,5,-8.45880117350225,-10.1826,-7.1206,-1
"5735",1,21,21,0,-14.0864303061158,-5.1826,-6.1206,3
"5736",1,12,5,-7,-11.8055671262231,1.8174,9.8794,-6
"5737",1,23,27,4,-13.2490710987541,-9.1826,-12.1206,5
"5738",1,17,23,6,-7.85338802640807,-11.1826,-8.1206,-1
"5739",1,20,15,-5,-16.5915117142451,-0.1826,-0.1206,2
"5740",1,16,23,7,-6.63769872958819,-12.1826,-8.1206,-2
"5741",1,14,5,-9,-14.6232679057439,3.8174,9.8794,-4
"5742",1,24,10,-14,-24.7678928408241,8.8174,4.8794,6
"5743",1,21,5,-16,-23.9913944152729,10.8174,9.8794,3
"5744",1,21,29,8,-9.23381383184955,-13.1826,-14.1206,3
"5745",1,18,30,12,-4.76788389040361,-17.1826,-15.1206,0
"5746",1,12,7,-5,-10.9130269156583,-0.1826,7.8794,-6
"5747",1,15,15,0,-10.052386484502,-5.1826,-0.1206,-3
"5748",1,19,1,-18,-23.8912639266529,12.8174,13.8794,1
"5749",1,16,13,-3,-12.6517836337347,-2.1826,1.8794,-2
"5750",1,16,2,-14,-18.9808324685959,8.8174,12.8794,-2
"5751",1,29,23,-6,-23.1410234241948,0.8174,-8.1206,11
"5752",1,17,4,-13,-19.1812226161394,7.8174,10.8794,-1
"5753",1,22,13,-9,-20.3461302758561,3.8174,1.8794,4
"5754",1,23,1,-22,-28.7493972444325,16.8174,13.8794,5
"5755",1,20,20,0,-13.5020242225394,-5.1826,-5.1206,2
"5756",1,18,22,4,-9.45676465702338,-9.1826,-7.1206,0
"5757",1,22,24,2,-13.7620481548719,-7.1826,-9.1206,4
"5758",1,23,15,-8,-20.400884823873,2.8174,-0.1206,5
"5759",1,28,28,0,-19.0759460661123,-5.1826,-13.1206,10
"5760",1,23,7,-16,-25.181010875019,10.8174,7.8794,5
"5761",1,20,11,-9,-18.7272336930793,3.8174,3.8794,2
"5762",1,27,28,1,-17.8537618105521,-6.1826,-13.1206,9
"5763",1,23,29,6,-12.0567209927165,-11.1826,-14.1206,5
"5764",1,20,9,-11,-19.9038418496425,5.8174,5.8794,2
"5765",1,21,5,-16,-23.9765224166903,10.8174,9.8794,3
"5766",1,15,23,8,-5.29338543824379,-13.1826,-8.1206,-3
"5767",1,20,5,-15,-22.4620523197256,9.8174,9.8794,2
"5768",1,21,19,-2,-15.2149254913573,-3.1826,-4.1206,3
"5769",1,25,13,-12,-24.1155254763569,6.8174,1.8794,7
"5770",1,23,12,-11,-21.9706302233743,5.8174,2.8794,5
"5771",1,23,30,7,-11.3923003994801,-12.1826,-15.1206,5
"5772",1,21,27,6,-10.2961289987747,-11.1826,-12.1206,3
"5773",1,21,9,-12,-21.4477697613119,6.8174,5.8794,3
"5774",1,16,1,-15,-19.5716370920668,9.8174,13.8794,-2
"5775",1,14,12,-2,-10.599527727801,-3.1826,2.8794,-4
"5776",1,27,0,-27,-34.6131101079925,21.8174,14.8794,9
"5777",1,31,14,-17,-31.3887398537255,11.8174,0.8794,13
"5778",1,22,11,-11,-21.5311332072319,5.8174,3.8794,4
"5779",1,28,26,-2,-20.2431465071466,-3.1826,-11.1206,10
"5780",1,17,28,11,-4.5974309163757,-16.1826,-13.1206,-1
"5781",1,25,9,-16,-26.4869605682456,10.8174,5.8794,7
"5782",1,21,16,-5,-17.1672961456317,-0.1826,-1.1206,3
"5783",1,19,28,9,-7.59594309782186,-14.1826,-13.1206,1
"5784",1,16,7,-9,-16.0239365738547,3.8174,7.8794,-2
"5785",1,24,27,3,-14.4483460620471,-8.1826,-12.1206,6
"5786",1,25,22,-3,-18.7392018959971,-2.1826,-7.1206,7
"5787",1,24,20,-4,-18.8548300434655,-1.1826,-5.1206,6
"5788",1,29,6,-23,-33.4348184516411,17.8174,8.8794,11
"5789",1,18,4,-14,-20.7031850690788,8.8174,10.8794,0
"5790",1,13,18,5,-5.48877521163517,-10.1826,-3.1206,-5
"5791",1,13,30,17,1.51608972046551,-22.1826,-15.1206,-5
"5792",1,26,27,1,-17.1996020276567,-6.1826,-12.1206,8
"5793",1,23,26,3,-13.732945258718,-8.1826,-11.1206,5
"5794",1,13,5,-8,-13.4124631891794,2.8174,9.8794,-5
"5795",1,14,20,6,-5.35890585930919,-11.1826,-5.1206,-4
"5796",1,26,26,0,-17.5988384927889,-5.1826,-11.1206,8
"5797",1,16,13,-3,-12.5494220001706,-2.1826,1.8794,-2
"5798",1,20,21,1,-12.943937552587,-6.1826,-6.1206,2
"5799",1,19,15,-4,-14.8822264015722,-1.1826,-0.1206,1
"5800",1,30,15,-15,-29.6567877507784,9.8174,-0.1206,12
"5801",1,17,15,-2,-12.731094347499,-3.1826,-0.1206,-1
"5802",1,24,21,-3,-17.9354498809491,-2.1826,-6.1206,6
"5803",1,14,13,-1,-9.76091205338818,-4.1826,1.8794,-4
"5804",1,24,8,-16,-26.0230503878799,10.8174,6.8794,6
"5805",1,25,18,-7,-21.3814234770434,1.8174,-3.1206,7
"5806",1,16,8,-8,-15.5188892262999,2.8174,6.8794,-2
"5807",1,18,11,-7,-16.0098645289652,1.8174,3.8794,0
"5808",1,19,20,1,-12.3930510307483,-6.1826,-5.1206,1
"5809",1,17,0,-17,-21.5529751624876,11.8174,14.8794,-1
"5810",1,15,20,5,-6.77967334643052,-10.1826,-5.1206,-3
"5811",1,21,6,-15,-23.1820308768317,9.8174,8.8794,3
"5812",1,17,23,6,-7.84436673228572,-11.1826,-8.1206,-1
"5813",1,16,25,9,-4.90663903383346,-14.1826,-10.1206,-2
"5814",1,13,9,-4,-10.910954779591,-1.1826,5.8794,-5
"5815",1,19,20,1,-12.2281997196371,-6.1826,-5.1206,1
"5816",1,16,19,3,-8.97192155189156,-8.1826,-4.1206,-2
"5817",1,16,21,5,-7.85997550537268,-10.1826,-6.1206,-2
"5818",1,26,14,-12,-24.6783757409424,6.8174,0.8794,8
"5819",1,27,21,-6,-21.8081242095789,0.8174,-6.1206,9
"5820",1,17,8,-9,-16.9715668388403,3.8174,6.8794,-1
"5821",1,17,9,-8,-16.1160975674235,2.8174,5.8794,-1
"5822",1,24,12,-12,-23.5132059106235,6.8174,2.8794,6
"5823",1,18,21,3,-10.3106178514841,-8.1826,-6.1206,0
"5824",1,16,1,-15,-19.7468514082384,9.8174,13.8794,-2
"5825",1,17,7,-10,-17.4001390242436,4.8174,7.8794,-1
"5826",1,20,22,2,-12.5202154373615,-7.1826,-7.1206,2
"5827",1,18,18,0,-12.0955966078282,-5.1826,-3.1206,0
"5828",1,21,26,5,-11.4636566139131,-10.1826,-11.1206,3
"5829",1,11,13,2,-5.60644029019133,-7.1826,1.8794,-7
"5830",1,20,25,5,-10.3141738232354,-10.1826,-10.1206,2
"5831",1,24,3,-21,-28.9882670192276,15.8174,11.8794,6
"5832",1,22,17,-5,-18.0724993352913,-0.1826,-2.1206,4
"5833",1,18,4,-14,-20.3336460499599,8.8174,10.8794,0
"5834",1,19,13,-6,-16.4101458461907,0.8174,1.8794,1
"5835",1,13,7,-6,-12.2353134884312,0.8174,7.8794,-5
"5836",1,15,1,-14,-18.360522334721,8.8174,13.8794,-3
"5837",1,21,14,-7,-18.708318967752,1.8174,0.8794,3
"5838",1,12,27,15,1.27573564000125,-20.1826,-12.1206,-6
"5839",1,26,3,-23,-31.4517202140512,17.8174,11.8794,8
"5840",1,13,11,-2,-9.83039308542264,-3.1826,3.8794,-5
"5841",1,21,6,-15,-23.0563333075262,9.8174,8.8794,3
"5842",1,18,9,-9,-17.4768555847584,3.8174,5.8794,0
"5843",1,17,27,10,-5.46239260364107,-15.1826,-12.1206,-1
"5844",1,22,25,3,-13.2937369294207,-8.1826,-10.1206,4
"5845",1,16,0,-16,-20.4128782028662,10.8174,14.8794,-2
"5846",1,22,4,-18,-25.6349587502077,12.8174,10.8794,4
"5847",1,27,23,-4,-20.637756986441,-1.1826,-8.1206,9
"5848",1,18,16,-2,-13.2882434936477,-3.1826,-1.1206,0
"5849",1,19,17,-2,-13.8103843118304,-3.1826,-2.1206,1
"5850",1,20,9,-11,-20.1933352568486,5.8174,5.8794,2
"5851",1,16,8,-8,-15.4852196178675,2.8174,6.8794,-2
"5852",1,14,23,9,-3.79996601862146,-14.1826,-8.1206,-4
"5853",1,25,30,5,-14.3888578329785,-10.1826,-15.1206,7
"5854",1,27,27,0,-18.3522836332048,-5.1826,-12.1206,9
"5855",1,21,17,-4,-16.4741266344511,-1.1826,-2.1206,3
"5856",1,28,22,-6,-22.5613740435016,0.8174,-7.1206,10
"5857",1,23,10,-13,-23.4172548461861,7.8174,4.8794,5
"5858",1,25,20,-5,-20.1014107018484,-0.1826,-5.1206,7
"5859",1,19,28,9,-7.34677136238346,-14.1826,-13.1206,1
"5860",1,18,18,0,-12.0436110164162,-5.1826,-3.1206,0
"5861",1,19,11,-8,-17.7245306137035,2.8174,3.8794,1
"5862",1,12,0,-12,-14.95744830024,6.8174,14.8794,-6
"5863",1,16,20,4,-8.3340323228922,-9.1826,-5.1206,-2
"5864",1,16,21,5,-7.61857453618332,-10.1826,-6.1206,-2
"5865",1,22,23,1,-14.4429357941705,-6.1826,-8.1206,4
"5866",1,22,29,7,-10.8185094092088,-12.1826,-14.1206,4
"5867",1,13,0,-13,-16.1742762250878,7.8174,14.8794,-5
"5868",1,21,25,4,-11.8429251497559,-9.1826,-10.1206,3
"5869",1,17,28,11,-4.89462285631289,-16.1826,-13.1206,-1
"5870",1,20,22,2,-12.3480759838807,-7.1826,-7.1206,2
"5871",1,30,22,-8,-25.3895952363856,2.8174,-7.1206,12
"5872",1,18,26,8,-7.21535970750754,-13.1826,-11.1206,0
"5873",1,24,22,-2,-17.5736953795873,-3.1826,-7.1206,6
"5874",1,21,4,-17,-24.3602551740197,11.8174,10.8794,3
"5875",1,14,6,-8,-14.2458231939248,2.8174,8.8794,-4
"5876",1,19,25,6,-9.24709010536348,-11.1826,-10.1206,1
"5877",1,14,28,14,-0.906847651194606,-19.1826,-13.1206,-4
"5878",1,19,26,7,-8.61809334739598,-12.1826,-11.1206,1
"5879",1,21,30,9,-8.96380650814708,-14.1826,-15.1206,3
"5880",1,14,29,15,-0.210047796366523,-20.1826,-14.1206,-4
"5881",1,16,4,-12,-17.6409397174469,6.8174,10.8794,-2
"5882",1,21,17,-4,-16.7967227741128,-1.1826,-2.1206,3
"5883",1,21,10,-11,-20.8032366606494,5.8174,4.8794,3
"5884",1,23,26,3,-13.9399097145634,-8.1826,-11.1206,5
"5885",1,25,23,-2,-17.8927445573359,-3.1826,-8.1206,7
"5886",1,28,29,1,-18.4199576578268,-6.1826,-14.1206,10
"5887",1,25,0,-25,-31.9057363373222,19.8174,14.8794,7
"5888",1,21,7,-14,-22.527956390991,8.8174,7.8794,3
"5889",1,22,0,-22,-27.9639398042563,16.8174,14.8794,4
"5890",1,28,23,-5,-22.0791764268848,-0.1826,-8.1206,10
"5891",1,15,13,-2,-11.236706525934,-3.1826,1.8794,-3
"5892",1,23,28,5,-12.4263085369951,-10.1826,-13.1206,5
"5893",1,20,18,-2,-14.9883779618566,-3.1826,-3.1206,2
"5894",1,21,6,-15,-23.3658508507659,9.8174,8.8794,3
"5895",1,24,13,-11,-22.9590878555378,5.8174,1.8794,6
"5896",1,16,8,-8,-15.4344154944017,2.8174,6.8794,-2
"5897",1,24,15,-9,-21.7243903378078,3.8174,-0.1206,6
"5898",1,20,4,-16,-23.075240920272,10.8174,10.8794,2
"5899",1,26,19,-7,-21.7807006320016,1.8174,-4.1206,8
"5900",1,23,23,0,-15.6639309876829,-5.1826,-8.1206,5
"5901",1,18,11,-7,-16.2624399140437,1.8174,3.8794,0
"5902",1,14,26,12,-2.19390670478852,-17.1826,-11.1206,-4
"5903",1,22,6,-16,-24.4385676641289,10.8174,8.8794,4
"5904",1,15,29,14,-1.64460228483978,-19.1826,-14.1206,-3
"5905",1,21,26,5,-11.3064887584319,-10.1826,-11.1206,3
"5906",1,21,21,0,-13.8567432019605,-5.1826,-6.1206,3
"5907",1,23,24,1,-14.895761898827,-6.1826,-9.1206,5
"5908",1,14,2,-12,-16.4815309318078,6.8174,12.8794,-4
"5909",1,19,12,-7,-16.9609066300844,1.8174,2.8794,1
"5910",1,16,26,10,-4.61553854350827,-15.1826,-11.1206,-2
"5911",1,18,4,-14,-20.5139344124104,8.8174,10.8794,0
"5912",1,21,8,-13,-21.8989066672698,7.8174,6.8794,3
"5913",1,23,10,-13,-23.6219067140716,7.8174,4.8794,5
"5914",1,17,0,-17,-21.2801165089712,11.8174,14.8794,-1
"5915",1,23,29,6,-12.1351525357677,-11.1826,-14.1206,5
"5916",1,13,9,-4,-11.0565553705141,-1.1826,5.8794,-5
"5917",1,21,0,-21,-26.5424474899586,15.8174,14.8794,3
"5918",1,11,28,17,3.12551436136865,-22.1826,-13.1206,-7
"5919",1,17,27,10,-5.73432098047146,-15.1826,-12.1206,-1
"5920",1,19,9,-10,-18.6793694161116,4.8174,5.8794,1
"5921",1,24,5,-19,-27.7725450110264,13.8174,9.8794,6
"5922",1,25,5,-20,-29.1341757097664,14.8174,9.8794,7
"5923",1,11,30,19,4.31965181541025,-24.1826,-15.1206,-7
"5924",1,22,16,-6,-18.7661961777767,0.8174,-1.1206,4
"5925",1,34,3,-31,-42.0285070020199,25.8174,11.8794,16
"5926",1,15,18,3,-8.2217714061948,-8.1826,-3.1206,-3
"5927",1,23,20,-3,-17.3641591293266,-2.1826,-5.1206,5
"5928",1,19,29,10,-6.78740241669561,-15.1826,-14.1206,1
"5929",1,25,20,-5,-19.9133402592293,-0.1826,-5.1206,7
"5930",1,27,21,-6,-21.8896950103282,0.8174,-6.1206,9
"5931",1,24,16,-8,-21.1297216341545,2.8174,-1.1206,6
"5932",1,22,18,-4,-17.1945260828871,-1.1826,-3.1206,4
"5933",1,31,0,-31,-39.8022321703981,25.8174,14.8794,13
"5934",1,20,13,-7,-17.7142465462817,1.8174,1.8794,2
"5935",1,19,29,10,-6.8060858285352,-15.1826,-14.1206,1
"5936",1,22,1,-21,-27.559200963804,15.8174,13.8794,4
"5937",1,23,14,-9,-20.9176641344956,3.8174,0.8794,5
"5938",1,21,22,1,-13.5576631028516,-6.1826,-7.1206,3
"5939",1,22,28,6,-11.2812602014212,-11.1826,-13.1206,4
"5940",1,20,19,-1,-14.1445954836133,-4.1826,-4.1206,2
"5941",1,17,30,13,-3.59909678178928,-18.1826,-15.1206,-1
"5942",1,14,13,-1,-9.87052434854471,-4.1826,1.8794,-4
"5943",1,20,4,-16,-23.1144495918037,10.8174,10.8794,2
"5944",1,26,3,-23,-31.4558005859277,17.8174,11.8794,8
"5945",1,24,23,-1,-16.7669344055141,-4.1826,-8.1206,6
"5946",1,22,16,-6,-18.8019376887458,0.8174,-1.1206,4
"5947",1,27,30,3,-16.4996172574391,-8.1826,-15.1206,9
"5948",1,25,0,-25,-32.0683668264407,19.8174,14.8794,7
"5949",1,21,25,4,-11.7726508905912,-9.1826,-10.1206,3
"5950",1,19,11,-8,-17.6904565602921,2.8174,3.8794,1
"5951",1,24,23,-1,-16.7149899251129,-4.1826,-8.1206,6
"5952",1,22,16,-6,-18.4161455455025,0.8174,-1.1206,4
"5953",1,22,18,-4,-17.2434897141658,-1.1826,-3.1206,4
"5954",1,20,28,8,-8.74753403529873,-13.1826,-13.1206,2
"5955",1,21,12,-9,-19.6237782339302,3.8174,2.8794,3
"5956",1,28,19,-9,-24.4760472791652,3.8174,-4.1206,10
"5957",1,24,30,6,-12.4325981935203,-11.1826,-15.1206,6
"5958",1,14,30,16,0.512211901080212,-21.1826,-15.1206,-4
"5959",1,22,11,-11,-21.5443865027312,5.8174,3.8794,4
"5960",1,20,7,-13,-21.1945169016373,7.8174,7.8794,2
"5961",1,20,29,9,-8.33048526616281,-14.1826,-14.1206,2
"5962",1,16,26,10,-4.65386807791088,-15.1826,-11.1206,-2
"5963",1,18,18,0,-12.3126961626891,-5.1826,-3.1206,0
"5964",1,23,1,-22,-28.719529066997,16.8174,13.8794,5
"5965",1,21,16,-5,-17.2320751211303,-0.1826,-1.1206,3
"5966",1,16,29,13,-2.57998807806393,-18.1826,-14.1206,-2
"5967",1,16,17,1,-10.2494588522052,-6.1826,-2.1206,-2
"5968",1,23,18,-5,-18.5268917831445,-0.1826,-3.1206,5
"5969",1,24,18,-6,-19.7444938663989,0.8174,-3.1206,6
"5970",1,23,8,-15,-24.3412916117435,9.8174,6.8794,5
"5971",1,19,24,5,-9.61030717324107,-10.1826,-9.1206,1
"5972",1,19,25,6,-9.34682936613967,-11.1826,-10.1206,1
"5973",1,14,10,-4,-11.5664612870686,-1.1826,4.8794,-4
"5974",1,15,2,-13,-17.8484712970008,7.8174,12.8794,-3
"5975",1,25,28,3,-15.2619899733153,-8.1826,-13.1206,7
"5976",1,25,25,0,-16.9729955265708,-5.1826,-10.1206,7
"5977",1,17,13,-4,-13.8633511458527,-1.1826,1.8794,-1
"5978",1,15,13,-2,-11.0197262266107,-3.1826,1.8794,-3
"5979",1,23,20,-3,-17.3309380106692,-2.1826,-5.1206,5
"5980",1,16,10,-6,-14.0436562998916,0.8174,4.8794,-2
"5981",1,16,13,-3,-12.7887504392116,-2.1826,1.8794,-2
"5982",1,10,5,-5,-9.59625865578119,-0.1826,9.8794,-8
"5983",1,21,25,4,-11.9372031046587,-9.1826,-10.1206,3
"5984",1,21,6,-15,-23.0332604486884,9.8174,8.8794,3
"5985",1,19,13,-6,-16.2601520571394,0.8174,1.8794,1
"5986",1,22,17,-5,-17.9671111933199,-0.1826,-2.1206,4
"5987",1,27,0,-27,-34.8783609799682,21.8174,14.8794,9
"5988",1,13,18,5,-5.75725098710757,-10.1826,-3.1206,-5
"5989",1,22,3,-19,-26.2752824353718,13.8174,11.8794,4
"5990",1,14,2,-12,-16.8979263310792,6.8174,12.8794,-4
"5991",1,24,11,-13,-24.1085450180458,7.8174,3.8794,6
"5992",1,15,2,-13,-17.8105676389546,7.8174,12.8794,-3
"5993",1,28,17,-11,-25.8838220898246,5.8174,-2.1206,10
"5994",1,27,5,-22,-31.7372389165697,16.8174,9.8794,9
"5995",1,24,12,-12,-23.4975795381678,6.8174,2.8794,6
"5996",1,25,28,3,-15.1853393515955,-8.1826,-13.1206,7
"5997",1,22,10,-12,-22.1903466123845,6.8174,4.8794,4
"5998",1,24,24,0,-16.2443407983899,-5.1826,-9.1206,6
"5999",1,20,10,-10,-19.508831605148,4.8174,4.8794,2
"6000",1,19,25,6,-9.43832752315271,-11.1826,-10.1206,1
"6001",1,18,9,-9,-17.2970501196594,3.8174,5.8794,0
"6002",1,22,12,-10,-20.665981672091,4.8174,2.8794,4
"6003",1,22,29,7,-10.5921074040422,-12.1826,-14.1206,4
"6004",1,22,21,-1,-15.6163142388465,-4.1826,-6.1206,4
"6005",1,17,21,4,-9.00128511027019,-9.1826,-6.1206,-1
"6006",1,21,3,-18,-24.8903673346762,12.8174,11.8794,3
"6007",1,28,21,-7,-23.1378761128124,1.8174,-6.1206,10
"6008",1,20,17,-3,-15.5351348744074,-2.1826,-2.1206,2
"6009",1,30,16,-14,-28.8651222263351,8.8174,-1.1206,12
"6010",1,21,29,8,-9.48933066268867,-13.1826,-14.1206,3
"6011",1,26,2,-24,-31.724701098465,18.8174,12.8794,8
"6012",1,16,14,-2,-12.1341693237958,-3.1826,0.8794,-2
"6013",1,29,12,-17,-30.01189355851,11.8174,2.8794,11
"6014",1,16,10,-6,-14.1496908977048,0.8174,4.8794,-2
"6015",1,15,10,-5,-12.9892815255665,-0.1826,4.8794,-3
"6016",1,17,10,-7,-15.5306410770999,1.8174,4.8794,-1
"6017",1,25,6,-19,-28.401875925229,13.8174,8.8794,7
"6018",1,22,12,-10,-20.9798658647022,4.8174,2.8794,4
"6019",1,16,16,0,-11.1249758966888,-5.1826,-1.1206,-2
"6020",1,15,22,7,-5.48772157179073,-12.1826,-7.1206,-3
"6021",1,19,16,-3,-14.3359558466369,-2.1826,-1.1206,1
"6022",1,24,21,-3,-18.0615939874069,-2.1826,-6.1206,6
"6023",1,20,27,7,-9.20579255893333,-12.1826,-12.1206,2
"6024",1,24,12,-12,-23.2179594925868,6.8174,2.8794,6
"6025",1,20,4,-16,-23.1617498382551,10.8174,10.8794,2
"6026",1,18,20,2,-10.4730199460793,-7.1826,-5.1206,0
"6027",1,21,8,-13,-21.9084764258575,7.8174,6.8794,3
"6028",1,19,5,-14,-21.1294181616607,8.8174,9.8794,1
"6029",1,17,17,0,-11.3047672667266,-5.1826,-2.1206,-1
"6030",1,13,13,0,-8.58631737791654,-5.1826,1.8794,-5
"6031",1,20,13,-7,-17.5988117298792,1.8174,1.8794,2
"6032",1,18,18,0,-11.7109136904863,-5.1826,-3.1206,0
"6033",1,22,27,5,-11.6501689404496,-10.1826,-12.1206,4
"6034",1,19,9,-10,-18.815035818191,4.8174,5.8794,1
"6035",1,25,19,-6,-20.575788475384,0.8174,-4.1206,7
"6036",1,16,29,13,-2.79660305424122,-18.1826,-14.1206,-2
"6037",1,22,25,3,-13.2838996129775,-8.1826,-10.1206,4
"6038",1,17,29,12,-4.08842075212705,-17.1826,-14.1206,-1
"6039",1,13,17,4,-6.04646301265188,-9.1826,-2.1206,-5
"6040",1,23,3,-20,-27.7390249811015,14.8174,11.8794,5
"6041",1,22,1,-21,-27.4588079308716,15.8174,13.8794,4
"6042",1,19,13,-6,-16.2470217364993,0.8174,1.8794,1
"6043",1,17,6,-11,-18.1664204922091,5.8174,8.8794,-1
"6044",1,16,5,-11,-17.1527016830327,5.8174,9.8794,-2
"6045",1,25,15,-10,-23.2526031546701,4.8174,-0.1206,7
"6046",1,13,17,4,-6.20284422398219,-9.1826,-2.1206,-5
"6047",1,21,27,6,-10.5689702079255,-11.1826,-12.1206,3
"6048",1,16,16,0,-10.7091353569123,-5.1826,-1.1206,-2
"6049",1,13,21,8,-4.00103869484448,-13.1826,-6.1206,-5
"6050",1,23,11,-12,-22.6292896718394,6.8174,3.8794,5
"6051",1,20,6,-14,-22.0368288691009,8.8174,8.8794,2
"6052",1,20,24,4,-11.3760185144644,-9.1826,-9.1206,2
"6053",1,30,14,-16,-30.1282063057018,10.8174,0.8794,12
"6054",1,23,24,1,-14.8373097840679,-6.1826,-9.1206,5
"6055",1,15,27,12,-2.7027138578966,-17.1826,-12.1206,-3
"6056",1,28,17,-11,-25.7417118843424,5.8174,-2.1206,10
"6057",1,17,1,-16,-20.9646837977315,10.8174,13.8794,-1
"6058",1,11,22,11,-0.408297943387677,-16.1826,-7.1206,-7
"6059",1,18,1,-17,-22.1097157222479,11.8174,13.8794,0
"6060",1,18,1,-17,-22.4947890016606,11.8174,13.8794,0
"6061",1,17,5,-12,-18.525828468783,6.8174,9.8794,-1
"6062",1,18,26,8,-7.28545033848416,-13.1826,-11.1206,0
"6063",1,19,23,4,-10.6513912184704,-9.1826,-8.1206,1
"6064",1,28,6,-22,-32.2195335932196,16.8174,8.8794,10
"6065",1,23,17,-6,-19.3139946944719,0.8174,-2.1206,5
"6066",1,27,12,-15,-27.4675011827809,9.8174,2.8794,9
"6067",1,21,23,2,-12.9733910103402,-7.1826,-8.1206,3
"6068",1,23,16,-7,-19.5982175790097,1.8174,-1.1206,5
"6069",1,14,30,16,0.299366398375513,-21.1826,-15.1206,-4
"6070",1,15,9,-6,-13.5482765283542,0.8174,5.8794,-3
"6071",1,19,9,-10,-18.6953234102474,4.8174,5.8794,1
"6072",1,26,5,-21,-30.349642429139,15.8174,9.8794,8
"6073",1,21,9,-12,-21.2662467057034,6.8174,5.8794,3
"6074",1,19,5,-14,-21.4633124574394,8.8174,9.8794,1
"6075",1,20,3,-17,-23.5722958102637,11.8174,11.8794,2
"6076",1,23,1,-22,-28.6606872791189,16.8174,13.8794,5
"6077",1,23,2,-21,-28.0549767703375,15.8174,12.8794,5
"6078",1,24,21,-3,-18.2608553838035,-2.1826,-6.1206,6
"6079",1,18,6,-12,-19.2416426944684,6.8174,8.8794,0
"6080",1,22,10,-12,-21.9227784819462,6.8174,4.8794,4
"6081",1,19,9,-10,-18.5223294814818,4.8174,5.8794,1
"6082",1,15,15,0,-10.0048395752212,-5.1826,-0.1206,-3
"6083",1,22,29,7,-10.7053847231602,-12.1826,-14.1206,4
"6084",1,17,18,1,-10.6829013383027,-6.1826,-3.1206,-1
"6085",1,17,1,-16,-20.9476121869249,10.8174,13.8794,-1
"6086",1,21,15,-6,-17.701515700471,0.8174,-0.1206,3
"6087",1,10,13,3,-4.81285027561456,-8.1826,1.8794,-8
"6088",1,21,29,8,-9.22580541611179,-13.1826,-14.1206,3
"6089",1,23,0,-23,-29.3513735941296,17.8174,14.8794,5
"6090",1,34,19,-15,-32.3907425351855,9.8174,-4.1206,16
"6091",1,17,12,-5,-14.4517887175952,-0.1826,2.8794,-1
"6092",1,21,22,1,-13.6954557144386,-6.1826,-7.1206,3
"6093",1,15,13,-2,-11.0717220659355,-3.1826,1.8794,-3
"6094",1,24,7,-17,-26.543248932913,11.8174,7.8794,6
"6095",1,25,5,-20,-29.1563011519312,14.8174,9.8794,7
"6096",1,13,10,-3,-10.7098634397769,-2.1826,4.8794,-5
"6097",1,14,9,-5,-12.2904419640339,-0.1826,5.8794,-4
"6098",1,17,11,-6,-15.3956379589697,0.8174,3.8794,-1
"6099",1,19,10,-9,-18.0295347169016,3.8174,4.8794,1
"6100",1,22,11,-11,-21.3252596616574,5.8174,3.8794,4
"6101",1,20,29,9,-8.08400992091557,-14.1826,-14.1206,2
"6102",1,22,13,-9,-20.4089778051062,3.8174,1.8794,4
"6103",1,16,3,-13,-18.244549852232,7.8174,11.8794,-2
"6104",1,19,26,7,-8.80849153593199,-12.1826,-11.1206,1
"6105",1,12,7,-5,-10.8357426476794,-0.1826,7.8794,-6
"6106",1,23,28,5,-12.7225808992143,-10.1826,-13.1206,5
"6107",1,19,21,2,-11.4640381357096,-7.1826,-6.1206,1
"6108",1,19,11,-8,-17.6159108792334,2.8174,3.8794,1
"6109",1,18,2,-16,-21.6816640907901,10.8174,12.8794,0
"6110",1,12,18,6,-4.52259631117416,-11.1826,-3.1206,-6
"6111",1,16,7,-9,-15.6644204673136,3.8174,7.8794,-2
"6112",1,21,6,-15,-23.3066517492229,9.8174,8.8794,3
"6113",1,18,22,4,-9.86439601715859,-9.1826,-7.1206,0
"6114",1,24,19,-5,-19.3267228297064,-0.1826,-4.1206,6
"6115",1,26,20,-6,-21.6420415318009,0.8174,-5.1206,8
"6116",1,24,6,-18,-27.0712629509652,12.8174,8.8794,6
"6117",1,16,4,-12,-17.826195098001,6.8174,10.8794,-2
"6118",1,23,5,-18,-26.4597549863349,12.8174,9.8794,5
"6119",1,19,16,-3,-14.6944515067404,-2.1826,-1.1206,1
"6120",1,16,10,-6,-14.0689841306848,0.8174,4.8794,-2
"6121",1,14,19,5,-6.55358143977311,-10.1826,-4.1206,-4
"6122",1,18,30,12,-4.92071296632954,-17.1826,-15.1206,0
"6123",1,15,11,-4,-12.5007768025187,-1.1826,3.8794,-3
"6124",1,22,5,-17,-25.1042475487973,11.8174,9.8794,4
"6125",1,23,4,-19,-27.1884305267599,13.8174,10.8794,5
"6126",1,14,20,6,-5.46363859414594,-11.1826,-5.1206,-4
"6127",1,25,28,3,-15.5195456013901,-8.1826,-13.1206,7
"6128",1,20,0,-20,-25.4784187842552,14.8174,14.8794,2
"6129",1,16,2,-14,-19.281158437095,8.8174,12.8794,-2
"6130",1,17,3,-14,-19.8236887190424,8.8174,11.8794,-1
"6131",1,25,2,-23,-30.6278879581766,17.8174,12.8794,7
"6132",1,32,9,-23,-35.7350917386457,17.8174,5.8794,14
"6133",1,17,8,-9,-16.8166180805548,3.8174,6.8794,-1
"6134",1,22,29,7,-10.9474961090869,-12.1826,-14.1206,4
"6135",1,16,20,4,-8.33189744585494,-9.1826,-5.1206,-2
"6136",1,25,21,-4,-19.1576542755399,-1.1826,-6.1206,7
"6137",1,15,8,-7,-14.4596654064984,1.8174,6.8794,-3
"6138",1,17,1,-16,-21.0620570925113,10.8174,13.8794,-1
"6139",1,20,2,-18,-24.2863823802328,12.8174,12.8794,2
"6140",1,19,5,-14,-21.2792263232711,8.8174,9.8794,1
"6141",1,30,24,-6,-24.2516116790316,0.8174,-9.1206,12
"6142",1,20,20,0,-13.5360004284801,-5.1826,-5.1206,2
"6143",1,25,3,-22,-30.5636845002394,16.8174,11.8794,7
"6144",1,19,30,11,-6.34204793276794,-16.1826,-15.1206,1
"6145",1,17,28,11,-4.83873636821701,-16.1826,-13.1206,-1
"6146",1,18,1,-17,-22.3552274454972,11.8174,13.8794,0
"6147",1,31,26,-5,-23.9878538403797,-0.1826,-11.1206,13
"6148",1,23,0,-23,-29.0105955049629,17.8174,14.8794,5
"6149",1,14,6,-8,-14.0842461126034,2.8174,8.8794,-4
"6150",1,17,19,2,-10.2512646621358,-7.1826,-4.1206,-1
"6151",1,18,11,-7,-16.3650415361307,1.8174,3.8794,0
"6152",1,22,25,3,-13.1290399951035,-8.1826,-10.1206,4
"6153",1,19,9,-10,-18.7602190091,4.8174,5.8794,1
"6154",1,18,16,-2,-13.2510237741625,-3.1826,-1.1206,0
"6155",1,16,6,-10,-16.6949954279284,4.8174,8.8794,-2
"6156",1,11,9,-2,-8.45498657120593,-3.1826,5.8794,-7
"6157",1,20,4,-16,-23.0180577243827,10.8174,10.8794,2
"6158",1,20,1,-19,-24.7893568467232,13.8174,13.8794,2
"6159",1,17,30,13,-3.94220501195719,-18.1826,-15.1206,-1
"6160",1,28,4,-24,-33.4606709336594,18.8174,10.8794,10
"6161",1,32,10,-22,-35.1806789322368,16.8174,4.8794,14
"6162",1,22,20,-2,-15.964436573299,-3.1826,-5.1206,4
"6163",1,23,16,-7,-19.7930987645597,1.8174,-1.1206,5
"6164",1,19,7,-12,-20.2299308448112,6.8174,7.8794,1
"6165",1,16,23,7,-6.48506101258322,-12.1826,-8.1206,-2
"6166",1,22,15,-7,-19.0206344949081,1.8174,-0.1206,4
"6167",1,20,16,-4,-15.809929890022,-1.1826,-1.1206,2
"6168",1,23,24,1,-15.2531145957475,-6.1826,-9.1206,5
"6169",1,20,16,-4,-15.9815571197204,-1.1826,-1.1206,2
"6170",1,23,12,-11,-22.0337014440546,5.8174,2.8794,5
"6171",1,18,13,-5,-15.1459063004865,-0.1826,1.8794,0
"6172",1,16,28,12,-3.32817112018891,-17.1826,-13.1206,-2
"6173",1,23,13,-10,-21.7133735398418,4.8174,1.8794,5
"6174",1,10,9,-1,-7.16435474865385,-4.1826,5.8794,-8
"6175",1,20,30,10,-7.51643715158256,-15.1826,-15.1206,2
"6176",1,22,24,2,-13.8099046612609,-7.1826,-9.1206,4
"6177",1,21,27,6,-10.8286504146624,-11.1826,-12.1206,3
"6178",1,29,18,-11,-26.2871181893459,5.8174,-3.1206,11
"6179",1,24,3,-21,-29.1177537837791,15.8174,11.8794,6
"6180",1,28,1,-27,-35.3142552149531,21.8174,13.8794,10
"6181",1,13,17,4,-6.07920693994881,-9.1826,-2.1206,-5
"6182",1,21,5,-16,-23.8298454606588,10.8174,9.8794,3
"6183",1,20,15,-5,-16.6061339682156,-0.1826,-0.1206,2
"6184",1,19,23,4,-10.459725731835,-9.1826,-8.1206,1
"6185",1,19,1,-18,-23.5544246345449,12.8174,13.8794,1
"6186",1,17,26,9,-6.04372200524755,-14.1826,-11.1206,-1
"6187",1,14,3,-11,-15.9269074651619,5.8174,11.8794,-4
"6188",1,21,0,-21,-26.8135214457352,15.8174,14.8794,3
"6189",1,21,3,-18,-25.1586021654884,12.8174,11.8794,3
"6190",1,32,29,-3,-23.5164754953655,-2.1826,-14.1206,14
"6191",1,30,18,-12,-27.6371902284251,6.8174,-3.1206,12
"6192",1,17,2,-15,-20.273554054482,9.8174,12.8794,-1
"6193",1,22,27,5,-11.9454734467317,-10.1826,-12.1206,4
"6194",1,19,0,-19,-24.0832741578135,13.8174,14.8794,1
"6195",1,20,0,-20,-25.3461939962454,14.8174,14.8794,2
"6196",1,14,28,14,-0.893494360631302,-19.1826,-13.1206,-4
"6197",1,11,17,6,-3.65835575740104,-11.1826,-2.1206,-7
"6198",1,23,13,-10,-21.6856328555228,4.8174,1.8794,5
"6199",1,23,22,-1,-16.31517777605,-4.1826,-7.1206,5
"6200",1,21,25,4,-12.0169266624182,-9.1826,-10.1206,3
"6201",1,23,10,-13,-23.4170596300577,7.8174,4.8794,5
"6202",1,25,16,-9,-22.1432440112404,3.8174,-1.1206,7
"6203",1,16,9,-7,-14.9572490795346,1.8174,5.8794,-2
"6204",1,22,14,-8,-19.7000775979833,2.8174,0.8794,4
"6205",1,18,18,0,-11.9991303267677,-5.1826,-3.1206,0
"6206",1,16,15,-1,-11.1150793687997,-4.1826,-0.1206,-2
"6207",1,25,16,-9,-22.418307554532,3.8174,-1.1206,7
"6208",1,8,17,9,0.363190055578175,-14.1826,-2.1206,-10
"6209",1,18,21,3,-10.329416222129,-8.1826,-6.1206,0
"6210",1,24,9,-15,-25.4167105121439,9.8174,5.8794,6
"6211",1,16,29,13,-2.86511876865344,-18.1826,-14.1206,-2
"6212",1,21,20,-1,-14.8323802264024,-4.1826,-5.1206,3
"6213",1,15,26,11,-3.28066890764919,-16.1826,-11.1206,-3
"6214",1,25,5,-20,-29.0014187826096,14.8174,9.8794,7
"6215",1,23,19,-4,-17.950603081953,-1.1826,-4.1206,5
"6216",1,19,7,-12,-20.0370283327629,6.8174,7.8794,1
"6217",1,27,30,3,-16.7135840470862,-8.1826,-15.1206,9
"6218",1,23,19,-4,-17.7728732379531,-1.1826,-4.1206,5
"6219",1,23,8,-15,-24.533999574072,9.8174,6.8794,5
"6220",1,15,26,11,-3.04621612284575,-16.1826,-11.1206,-3
"6221",1,20,1,-19,-24.6408448035871,13.8174,13.8794,2
"6222",1,21,9,-12,-21.5987681835284,6.8174,5.8794,3
"6223",1,19,14,-5,-15.7752852183571,-0.1826,0.8794,1
"6224",1,25,19,-6,-20.7430447661762,0.8174,-4.1206,7
"6225",1,23,12,-11,-22.2663923513475,5.8174,2.8794,5
"6226",1,15,20,5,-6.96416731381588,-10.1826,-5.1206,-3
"6227",1,20,13,-7,-17.6684537205637,1.8174,1.8794,2
"6228",1,21,17,-4,-16.5667335771588,-1.1826,-2.1206,3
"6229",1,16,19,3,-8.97342729081684,-8.1826,-4.1206,-2
"6230",1,26,29,3,-15.9535099089645,-8.1826,-14.1206,8
"6231",1,15,28,13,-2.37263723449503,-18.1826,-13.1206,-3
"6232",1,17,15,-2,-12.6982054286845,-3.1826,-0.1206,-1
"6233",1,27,2,-25,-33.4982273009013,19.8174,12.8794,9
"6234",1,13,12,-1,-8.98500098321794,-4.1826,2.8794,-5
"6235",1,18,27,9,-6.57889302808199,-14.1826,-12.1206,0
"6236",1,17,21,4,-9.19408262641701,-9.1826,-6.1206,-1
"6237",1,24,22,-2,-17.3562926507235,-3.1826,-7.1206,6
"6238",1,20,13,-7,-17.6858040540209,1.8174,1.8794,2
"6239",1,16,1,-15,-19.5322671941587,9.8174,13.8794,-2
"6240",1,9,4,-5,-8.57639630099457,-0.1826,10.8794,-9
"6241",1,16,21,5,-7.63062695482168,-10.1826,-6.1206,-2
"6242",1,12,19,7,-3.52263903475202,-12.1826,-4.1206,-6
"6243",1,20,9,-11,-20.3796178562618,5.8174,5.8794,2
"6244",1,17,20,3,-9.74283786135587,-8.1826,-5.1206,-1
"6245",1,22,27,5,-12.1796388734736,-10.1826,-12.1206,4
"6246",1,20,25,5,-10.4965522002243,-10.1826,-10.1206,2
"6247",1,17,6,-11,-18.1167693075693,5.8174,8.8794,-1
"6248",1,23,4,-19,-26.9851235115681,13.8174,10.8794,5
"6249",1,14,22,8,-4.59408453355609,-13.1826,-7.1206,-4
"6250",1,33,20,-13,-30.583958679976,7.8174,-5.1206,15
"6251",1,22,11,-11,-21.5546970644315,5.8174,3.8794,4
"6252",1,20,22,2,-12.5163018032266,-7.1826,-7.1206,2
"6253",1,19,6,-13,-20.5691838565701,7.8174,8.8794,1
"6254",1,23,16,-7,-19.9861576870815,1.8174,-1.1206,5
"6255",1,20,21,1,-13.0691317393591,-6.1826,-6.1206,2
"6256",1,25,23,-2,-18.1626909022751,-3.1826,-8.1206,7
"6257",1,16,9,-7,-14.5507904921788,1.8174,5.8794,-2
"6258",1,30,0,-30,-38.7192447843183,24.8174,14.8794,12
"6259",1,14,8,-6,-13.1129374547744,0.8174,6.8794,-4
"6260",1,19,18,-1,-13.5874357314331,-4.1826,-3.1206,1
"6261",1,17,28,11,-4.72111923390403,-16.1826,-13.1206,-1
"6262",1,26,14,-12,-25.105863250541,6.8174,0.8794,8
"6263",1,22,23,1,-14.2462586735962,-6.1826,-8.1206,4
"6264",1,25,14,-11,-23.8646476529401,5.8174,0.8794,7
"6265",1,17,16,-1,-12.143197390796,-4.1826,-1.1206,-1
"6266",1,14,8,-6,-12.8027635916816,0.8174,6.8794,-4
"6267",1,20,30,10,-7.54534801040132,-15.1826,-15.1206,2
"6268",1,13,5,-8,-13.4024444886243,2.8174,9.8794,-5
"6269",1,18,1,-17,-22.3275473656409,11.8174,13.8794,0
"6270",1,16,18,2,-9.62887873246395,-7.1826,-3.1206,-2
"6271",1,26,15,-11,-24.3317762278469,5.8174,-0.1206,8
"6272",1,19,12,-7,-16.8150359112042,1.8174,2.8794,1
"6273",1,18,5,-13,-19.8117637018885,7.8174,9.8794,0
"6274",1,15,16,1,-9.44110381784573,-6.1826,-1.1206,-3
"6275",1,19,12,-7,-17.3555451155814,1.8174,2.8794,1
"6276",1,15,16,1,-9.33841497176844,-6.1826,-1.1206,-3
"6277",1,24,30,6,-12.7149221215812,-11.1826,-15.1206,6
"6278",1,21,10,-11,-20.8418493412849,5.8174,4.8794,3
"6279",1,25,24,-1,-17.4930329411567,-4.1826,-9.1206,7
"6280",1,25,14,-11,-23.3683884037553,5.8174,0.8794,7
"6281",1,21,0,-21,-26.6383229281274,15.8174,14.8794,3
"6282",1,25,15,-10,-22.7587380690603,4.8174,-0.1206,7
"6283",1,17,15,-2,-12.8693350837732,-3.1826,-0.1206,-1
"6284",1,17,13,-4,-13.8896826444092,-1.1826,1.8794,-1
"6285",1,29,29,0,-19.5921575280677,-5.1826,-14.1206,11
"6286",1,22,21,-1,-15.228933074243,-4.1826,-6.1206,4
"6287",1,18,17,-1,-12.6533730680112,-4.1826,-2.1206,0
"6288",1,22,22,0,-14.7131361857898,-5.1826,-7.1206,4
"6289",1,16,5,-11,-17.387117594475,5.8174,9.8794,-2
"6290",1,19,20,1,-12.0136697561897,-6.1826,-5.1206,1
"6291",1,17,8,-9,-16.5429245207803,3.8174,6.8794,-1
"6292",1,23,2,-21,-27.9559883926824,15.8174,12.8794,5
"6293",1,31,19,-12,-28.3041566366661,6.8174,-4.1206,13
"6294",1,14,29,15,-0.0211452124009165,-20.1826,-14.1206,-4
"6295",1,20,7,-13,-21.4464235696399,7.8174,7.8794,2
"6296",1,23,15,-8,-20.4184159607881,2.8174,-0.1206,5
"6297",1,19,15,-4,-15.1183302424051,-1.1826,-0.1206,1
"6298",1,19,5,-14,-21.0624109476776,8.8174,9.8794,1
"6299",1,22,4,-18,-25.4403130797677,12.8174,10.8794,4
"6300",1,20,30,10,-7.43197801509863,-15.1826,-15.1206,2
"6301",1,24,12,-12,-23.5349613625464,6.8174,2.8794,6
"6302",1,19,7,-12,-19.8963706760028,6.8174,7.8794,1
"6303",1,17,27,10,-5.27909316268631,-15.1826,-12.1206,-1
"6304",1,31,30,-1,-21.5805181229782,-4.1826,-15.1206,13
"6305",1,14,17,3,-7.31381395778415,-8.1826,-2.1206,-4
"6306",1,27,23,-4,-20.8168602194722,-1.1826,-8.1206,9
"6307",1,35,1,-34,-44.5322636262132,28.8174,13.8794,17
"6308",1,17,17,0,-11.6481568056597,-5.1826,-2.1206,-1
"6309",1,19,11,-8,-17.8676632961167,2.8174,3.8794,1
"6310",1,22,14,-8,-19.8475935101057,2.8174,0.8794,4
"6311",1,17,5,-12,-18.7154351464591,6.8174,9.8794,-1
"6312",1,22,13,-9,-20.1385692261724,3.8174,1.8794,4
"6313",1,19,14,-5,-15.5337755923775,-0.1826,0.8794,1
"6314",1,17,0,-17,-21.5285489292958,11.8174,14.8794,-1
"6315",1,25,4,-21,-29.7810932819745,15.8174,10.8794,7
"6316",1,25,0,-25,-31.9864659519282,19.8174,14.8794,7
"6317",1,11,19,8,-2.26831790801644,-13.1826,-4.1206,-7
"6318",1,26,17,-9,-23.1424826812727,3.8174,-2.1206,8
"6319",1,15,4,-11,-16.5947983943673,5.8174,10.8794,-3
"6320",1,14,13,-1,-9.94575683940567,-4.1826,1.8794,-4
"6321",1,28,17,-11,-26.013820157384,5.8174,-2.1206,10
"6322",1,17,23,6,-7.60723193224541,-11.1826,-8.1206,-1
"6323",1,20,9,-11,-20.2638204812494,5.8174,5.8794,2
"6324",1,19,24,5,-10.0251464698212,-10.1826,-9.1206,1
"6325",1,20,16,-4,-15.9410241765566,-1.1826,-1.1206,2
"6326",1,24,10,-14,-24.595286135976,8.8174,4.8794,6
"6327",1,23,29,6,-11.7488510439518,-11.1826,-14.1206,5
"6328",1,19,0,-19,-24.1735735453629,13.8174,14.8794,1
"6329",1,22,25,3,-13.1412047729159,-8.1826,-10.1206,4
"6330",1,19,20,1,-12.295574437248,-6.1826,-5.1206,1
"6331",1,20,24,4,-11.2356047198455,-9.1826,-9.1206,2
"6332",1,20,16,-4,-16.0511122921314,-1.1826,-1.1206,2
"6333",1,21,14,-7,-18.2581843549888,1.8174,0.8794,3
"6334",1,19,19,0,-12.8696848972556,-5.1826,-4.1206,1
"6335",1,12,1,-11,-14.6953048073518,5.8174,13.8794,-6
"6336",1,12,6,-6,-11.4295056208566,0.8174,8.8794,-6
"6337",1,25,27,2,-15.9294275028045,-7.1826,-12.1206,7
"6338",1,21,18,-3,-16.073761182605,-2.1826,-3.1206,3
"6339",1,17,10,-7,-15.7361621431372,1.8174,4.8794,-1
"6340",1,26,5,-21,-30.3462737127977,15.8174,9.8794,8
"6341",1,19,8,-11,-19.4750263689812,5.8174,6.8794,1
"6342",1,19,2,-17,-23.0464951252828,11.8174,12.8794,1
"6343",1,19,22,3,-10.9846976883165,-8.1826,-7.1206,1
"6344",1,18,22,4,-9.71701031034289,-9.1826,-7.1206,0
"6345",1,18,30,12,-4.74509978608353,-17.1826,-15.1206,0
"6346",1,19,30,11,-6.25988141362733,-16.1826,-15.1206,1
"6347",1,21,28,7,-10.0324328945704,-12.1826,-13.1206,3
"6348",1,16,12,-4,-13.0290261293977,-1.1826,2.8794,-2
"6349",1,27,17,-10,-24.5382092189347,4.8174,-2.1206,9
"6350",1,23,15,-8,-20.2661819725475,2.8174,-0.1206,5
"6351",1,22,17,-5,-17.822467054728,-0.1826,-2.1206,4
"6352",1,13,25,12,-1.5016835962441,-17.1826,-10.1206,-5
"6353",1,24,2,-22,-29.4914877426407,16.8174,12.8794,6
"6354",1,28,20,-8,-23.9788196658349,2.8174,-5.1206,10
"6355",1,20,11,-9,-18.8468603256252,3.8174,3.8794,2
"6356",1,13,20,7,-4.45728651103448,-12.1826,-5.1206,-5
"6357",1,25,9,-16,-26.9558228810764,10.8174,5.8794,7
"6358",1,16,9,-7,-14.7775170592336,1.8174,5.8794,-2
"6359",1,14,1,-13,-17.2505182683319,7.8174,13.8794,-4
"6360",1,22,9,-13,-22.5851206545293,7.8174,5.8794,4
"6361",1,24,9,-15,-25.3118145104917,9.8174,5.8794,6
"6362",1,17,17,0,-11.2969709627215,-5.1826,-2.1206,-1
"6363",1,17,20,3,-9.6302318057248,-8.1826,-5.1206,-1
"6364",1,18,0,-18,-22.8429402018055,12.8174,14.8794,0
"6365",1,15,30,15,-1.19222886999186,-20.1826,-15.1206,-3
"6366",1,12,29,17,2.3306086619004,-22.1826,-14.1206,-6
"6367",1,13,15,2,-7.7248044743599,-7.1826,-0.1206,-5
"6368",1,18,5,-13,-19.8571474222755,7.8174,9.8794,0
"6369",1,28,13,-15,-28.0844286712434,9.8174,1.8794,10
"6370",1,23,16,-7,-19.8118156164719,1.8174,-1.1206,5
"6371",1,22,8,-14,-23.6771830990391,8.8174,6.8794,4
"6372",1,15,25,10,-3.73260571960474,-15.1826,-10.1206,-3
"6373",1,13,5,-8,-13.2604354337863,2.8174,9.8794,-5
"6374",1,23,5,-18,-26.1592190303051,12.8174,9.8794,5
"6375",1,32,29,-3,-23.8688494524619,-2.1826,-14.1206,14
"6376",1,17,16,-1,-12.0382493067749,-4.1826,-1.1206,-1
"6377",1,24,0,-24,-30.7562008764923,18.8174,14.8794,6
"6378",1,21,30,9,-8.90924354821713,-14.1826,-15.1206,3
"6379",1,23,24,1,-14.9742091598554,-6.1826,-9.1206,5
"6380",1,15,0,-15,-19.186274591597,9.8174,14.8794,-3
"6381",1,27,20,-7,-22.8040688632492,1.8174,-5.1206,9
"6382",1,16,15,-1,-11.3139233893635,-4.1826,-0.1206,-2
"6383",1,12,22,10,-1.65462045269206,-15.1826,-7.1206,-6
"6384",1,16,29,13,-2.98717474491399,-18.1826,-14.1206,-2
"6385",1,22,6,-16,-24.5769054829491,10.8174,8.8794,4
"6386",1,27,22,-5,-21.355683328921,-0.1826,-7.1206,9
"6387",1,30,2,-28,-37.1459419658611,22.8174,12.8794,12
"6388",1,16,12,-4,-13.0361587342317,-1.1826,2.8794,-2
"6389",1,17,0,-17,-21.6318743584999,11.8174,14.8794,-1
"6390",1,14,4,-10,-15.2987651106833,4.8174,10.8794,-4
"6391",1,17,11,-6,-15.1963904667607,0.8174,3.8794,-1
"6392",1,18,5,-13,-19.8398253036299,7.8174,9.8794,0
"6393",1,19,0,-19,-24.167942710819,13.8174,14.8794,1
"6394",1,23,21,-2,-16.9555262158748,-3.1826,-6.1206,5
"6395",1,22,0,-22,-27.9152057567867,16.8174,14.8794,4
"6396",1,24,7,-17,-26.6091309137429,11.8174,7.8794,6
"6397",1,16,16,0,-10.6935145141848,-5.1826,-1.1206,-2
"6398",1,23,10,-13,-23.1401792632683,7.8174,4.8794,5
"6399",1,20,1,-19,-24.9415507887497,13.8174,13.8794,2
"6400",1,29,7,-22,-33.0179822674948,16.8174,7.8794,11
"6401",1,20,9,-11,-19.9584658445435,5.8174,5.8794,2
"6402",1,16,30,14,-2.59670381550552,-19.1826,-15.1206,-2
"6403",1,21,21,0,-14.1540954079232,-5.1826,-6.1206,3
"6404",1,19,29,10,-6.97479511808492,-15.1826,-14.1206,1
"6405",1,22,19,-3,-16.7288907021353,-2.1826,-4.1206,4
"6406",1,23,12,-11,-22.3168689745606,5.8174,2.8794,5
"6407",1,18,28,10,-5.94350599452457,-15.1826,-13.1206,0
"6408",1,16,16,0,-10.4908336782577,-5.1826,-1.1206,-2
"6409",1,21,21,0,-14.4703116819458,-5.1826,-6.1206,3
"6410",1,18,13,-5,-14.9239123210487,-0.1826,1.8794,0
"6411",1,33,26,-7,-26.7382379467356,1.8174,-11.1206,15
"6412",1,21,21,0,-13.9094123811986,-5.1826,-6.1206,3
"6413",1,16,17,1,-10.0711154614029,-6.1826,-2.1206,-2
"6414",1,23,9,-14,-23.8074810697392,8.8174,5.8794,5
"6415",1,16,21,5,-7.47340156119803,-10.1826,-6.1206,-2
"6416",1,21,17,-4,-16.4152816066577,-1.1826,-2.1206,3
"6417",1,28,5,-23,-32.9326062968466,17.8174,9.8794,10
"6418",1,23,1,-22,-28.7583520520181,16.8174,13.8794,5
"6419",1,24,30,6,-12.6781281413475,-11.1826,-15.1206,6
"6420",1,21,0,-21,-27.0737361276036,15.8174,14.8794,3
"6421",1,27,17,-10,-24.3933142574246,4.8174,-2.1206,9
"6422",1,18,4,-14,-20.8813654725155,8.8174,10.8794,0
"6423",1,15,26,11,-3.16383947853474,-16.1826,-11.1206,-3
"6424",1,20,8,-12,-20.7108062150141,6.8174,6.8794,2
"6425",1,26,21,-5,-20.3443064341203,-0.1826,-6.1206,8
"6426",1,16,20,4,-8.28375863074786,-9.1826,-5.1206,-2
"6427",1,16,10,-6,-14.2822007767649,0.8174,4.8794,-2
"6428",1,23,11,-12,-22.4980670806181,6.8174,3.8794,5
"6429",1,23,20,-3,-17.3288395970919,-2.1826,-5.1206,5
"6430",1,12,6,-6,-11.4573579629991,0.8174,8.8794,-6
"6431",1,22,29,7,-10.8563631766813,-12.1826,-14.1206,4
"6432",1,16,11,-5,-13.4022878190278,-0.1826,3.8794,-2
"6433",1,21,21,0,-14.1268869396984,-5.1826,-6.1206,3
"6434",1,20,15,-5,-16.5656384752001,-0.1826,-0.1206,2
"6435",1,18,5,-13,-19.9802701723543,7.8174,9.8794,0
"6436",1,15,27,12,-2.83637236501955,-17.1826,-12.1206,-3
"6437",1,12,5,-7,-11.9772044338046,1.8174,9.8794,-6
"6438",1,22,20,-2,-16.0097641833743,-3.1826,-5.1206,4
"6439",1,22,9,-13,-22.566931801638,7.8174,5.8794,4
"6440",1,20,0,-20,-25.632777496657,14.8174,14.8794,2
"6441",1,23,6,-17,-25.8152312139808,11.8174,8.8794,5
"6442",1,16,27,11,-4.02132676542355,-16.1826,-12.1206,-2
"6443",1,19,6,-13,-20.4824349871692,7.8174,8.8794,1
"6444",1,16,15,-1,-11.2912675861236,-4.1826,-0.1206,-2
"6445",1,28,1,-27,-35.3810305649335,21.8174,13.8794,10
"6446",1,25,9,-16,-26.5679975967391,10.8174,5.8794,7
"6447",1,32,9,-23,-35.8618932380331,17.8174,5.8794,14
"6448",1,19,9,-10,-18.8632362701262,4.8174,5.8794,1
"6449",1,14,13,-1,-9.86971922909441,-4.1826,1.8794,-4
"6450",1,16,7,-9,-15.9613181625938,3.8174,7.8794,-2
"6451",1,11,30,19,3.99314111723712,-24.1826,-15.1206,-7
"6452",1,22,13,-9,-20.1754601163656,3.8174,1.8794,4
"6453",1,15,13,-2,-11.4592273327885,-3.1826,1.8794,-3
"6454",1,15,5,-10,-16.1495869337891,4.8174,9.8794,-3
"6455",1,18,0,-18,-23.0426048220829,12.8174,14.8794,0
"6456",1,19,19,0,-13.0399220726897,-5.1826,-4.1206,1
"6457",1,26,12,-14,-25.8954103495985,8.8174,2.8794,8
"6458",1,22,14,-8,-19.5295110064505,2.8174,0.8794,4
"6459",1,18,3,-15,-21.1971537817117,9.8174,11.8794,0
"6460",1,17,30,13,-3.78708062541237,-18.1826,-15.1206,-1
"6461",1,8,13,5,-2.22622685967515,-10.1826,1.8794,-10
"6462",1,20,30,10,-7.72648863030967,-15.1826,-15.1206,2
"6463",1,20,27,7,-9.27118025422699,-12.1826,-12.1206,2
"6464",1,17,0,-17,-21.702944041026,11.8174,14.8794,-1
"6465",1,8,8,0,-5.04488238182186,-5.1826,6.8794,-10
"6466",1,20,9,-11,-19.9617674701452,5.8174,5.8794,2
"6467",1,20,11,-9,-18.8522183409918,3.8174,3.8794,2
"6468",1,13,27,14,-0.125885186548935,-19.1826,-12.1206,-5
"6469",1,16,15,-1,-11.4487485590719,-4.1826,-0.1206,-2
"6470",1,18,9,-9,-17.7104248274453,3.8174,5.8794,0
"6471",1,20,23,3,-11.5637523571035,-8.1826,-8.1206,2
"6472",1,18,29,11,-5.66583647168355,-16.1826,-14.1206,0
"6473",1,26,6,-20,-29.333547493167,14.8174,8.8794,8
"6474",1,28,15,-13,-26.8777970332993,7.8174,-0.1206,10
"6475",1,23,20,-3,-17.1719874880141,-2.1826,-5.1206,5
"6476",1,16,14,-2,-11.7258412264808,-3.1826,0.8794,-2
"6477",1,18,11,-7,-16.2223680523412,1.8174,3.8794,0
"6478",1,15,25,10,-4.13864902754261,-15.1826,-10.1206,-3
"6479",1,22,20,-2,-15.9887778469079,-3.1826,-5.1206,4
"6480",1,19,16,-3,-14.6404527222739,-2.1826,-1.1206,1
"6481",1,19,18,-1,-13.1509178618288,-4.1826,-3.1206,1
"6482",1,19,14,-5,-15.7938657046702,-0.1826,0.8794,1
"6483",1,26,21,-5,-20.6296569559166,-0.1826,-6.1206,8
"6484",1,24,12,-12,-23.5944480303866,6.8174,2.8794,6
"6485",1,16,28,12,-3.1309335309352,-17.1826,-13.1206,-2
"6486",1,18,10,-8,-16.4044694366672,2.8174,4.8794,0
"6487",1,16,18,2,-9.74766260572544,-7.1826,-3.1206,-2
"6488",1,25,6,-19,-28.6457835012026,13.8174,8.8794,7
"6489",1,19,7,-12,-20.0517973341818,6.8174,7.8794,1
"6490",1,14,18,4,-7.13195901583713,-9.1826,-3.1206,-4
"6491",1,18,0,-18,-22.8244804146689,12.8174,14.8794,0
"6492",1,15,2,-13,-17.7328658353759,7.8174,12.8794,-3
"6493",1,11,7,-4,-9.46991075601086,-1.1826,7.8794,-7
"6494",1,23,7,-16,-25.2986980061085,10.8174,7.8794,5
"6495",1,18,5,-13,-19.7639256542166,7.8174,9.8794,0
"6496",1,21,11,-10,-19.994187627553,4.8174,3.8794,3
"6497",1,21,26,5,-11.2553782840562,-10.1826,-11.1206,3
"6498",1,15,14,-1,-10.4374883074974,-4.1826,0.8794,-3
"6499",1,26,10,-16,-27.2428913946862,10.8174,4.8794,8
"6500",1,18,3,-15,-20.9985386412735,9.8174,11.8794,0
"6501",1,18,6,-12,-19.2907937479567,6.8174,8.8794,0
"6502",1,16,9,-7,-14.9790629449647,1.8174,5.8794,-2
"6503",1,18,2,-16,-21.7894396045158,10.8174,12.8794,0
"6504",1,17,29,12,-4.36188893518532,-17.1826,-14.1206,-1
"6505",1,23,0,-23,-29.3430923241514,17.8174,14.8794,5
"6506",1,23,8,-15,-24.4962130363345,9.8174,6.8794,5
"6507",1,14,4,-10,-15.2493558215838,4.8174,10.8794,-4
"6508",1,24,15,-9,-21.559343351352,3.8174,-0.1206,6
"6509",1,18,0,-18,-22.8195097165677,12.8174,14.8794,0
"6510",1,16,23,7,-6.25847220654196,-12.1826,-8.1206,-2
"6511",1,22,16,-6,-18.5648362998682,0.8174,-1.1206,4
"6512",1,18,12,-6,-15.6854480067048,0.8174,2.8794,0
"6513",1,19,7,-12,-19.8597256328922,6.8174,7.8794,1
"6514",1,23,5,-18,-26.5970722378107,12.8174,9.8794,5
"6515",1,23,26,3,-13.7409211254964,-8.1826,-11.1206,5
"6516",1,10,10,0,-6.45557692289812,-5.1826,4.8794,-8
"6517",1,16,29,13,-2.84825858289827,-18.1826,-14.1206,-2
"6518",1,19,2,-17,-23.119370020092,11.8174,12.8794,1
"6519",1,16,3,-13,-18.5748551005838,7.8174,11.8794,-2
"6520",1,16,30,14,-2.30788493000207,-19.1826,-15.1206,-2
"6521",1,18,6,-12,-19.4573566305399,6.8174,8.8794,0
"6522",1,22,5,-17,-25.0355140020936,11.8174,9.8794,4
"6523",1,16,21,5,-8.01285288036997,-10.1826,-6.1206,-2
"6524",1,18,5,-13,-19.8396166453549,7.8174,9.8794,0
"6525",1,23,11,-12,-22.4844622865922,6.8174,3.8794,5
"6526",1,19,16,-3,-14.3406166225225,-2.1826,-1.1206,1
"6527",1,25,29,4,-14.494327004897,-9.1826,-14.1206,7
"6528",1,24,21,-3,-18.0784766240644,-2.1826,-6.1206,6
"6529",1,22,19,-3,-16.777704885439,-2.1826,-4.1206,4
"6530",1,19,30,11,-6.21336784925683,-16.1826,-15.1206,1
"6531",1,19,20,1,-12.4720870492005,-6.1826,-5.1206,1
"6532",1,24,5,-19,-27.6623608769772,13.8174,9.8794,6
"6533",1,20,1,-19,-24.9225533700333,13.8174,13.8794,2
"6534",1,21,16,-5,-17.2601464125771,-0.1826,-1.1206,3
"6535",1,14,28,14,-1.00950986671495,-19.1826,-13.1206,-4
"6536",1,23,0,-23,-29.5328372072048,17.8174,14.8794,5
"6537",1,21,3,-18,-25.0789389028831,12.8174,11.8794,3
"6538",1,17,25,8,-6.61352610029015,-13.1826,-10.1206,-1
"6539",1,10,11,1,-5.96276865343308,-6.1826,3.8794,-8
"6540",1,18,11,-7,-16.1659110278093,1.8174,3.8794,0
"6541",1,20,13,-7,-17.6490543571836,1.8174,1.8794,2
"6542",1,18,11,-7,-16.0879224237479,1.8174,3.8794,0
"6543",1,21,23,2,-12.8197094311543,-7.1826,-8.1206,3
"6544",1,21,13,-8,-19.040469309843,2.8174,1.8794,3
"6545",1,28,10,-18,-29.7451372938409,12.8174,4.8794,10
"6546",1,19,22,3,-10.7796089763124,-8.1826,-7.1206,1
"6547",1,17,4,-13,-19.1380611762355,7.8174,10.8794,-1
"6548",1,16,22,6,-6.96059594694318,-11.1826,-7.1206,-2
"6549",1,17,16,-1,-12.0665631914205,-4.1826,-1.1206,-1
"6550",1,25,26,1,-16.5347293456541,-6.1826,-11.1206,7
"6551",1,25,17,-8,-21.6863621780659,2.8174,-2.1206,7
"6552",1,10,7,-3,-8.43066048867441,-2.1826,7.8794,-8
"6553",1,22,22,0,-14.7479887047947,-5.1826,-7.1206,4
"6554",1,18,20,2,-11.0123115207822,-7.1826,-5.1206,0
"6555",1,17,23,6,-7.77266421893605,-11.1826,-8.1206,-1
"6556",1,11,23,12,0.0948141286772003,-17.1826,-8.1206,-7
"6557",1,20,4,-16,-23.0399650061607,10.8174,10.8794,2
"6558",1,24,29,5,-13.1941695535115,-10.1826,-14.1206,6
"6559",1,21,23,2,-13.0280203346512,-7.1826,-8.1206,3
"6560",1,18,25,7,-7.89747727815792,-12.1826,-10.1206,0
"6561",1,11,14,3,-5.19638605154174,-8.1826,0.8794,-7
"6562",1,15,30,15,-1.00977991174656,-20.1826,-15.1206,-3
"6563",1,17,19,2,-10.2108683140152,-7.1826,-4.1206,-1
"6564",1,28,27,-1,-19.7890690642223,-4.1826,-12.1206,10
"6565",1,25,3,-22,-29.9413872984444,16.8174,11.8794,7
"6566",1,25,25,0,-16.9428801884992,-5.1826,-10.1206,7
"6567",1,14,13,-1,-9.80352544674218,-4.1826,1.8794,-4
"6568",1,20,22,2,-12.1354623228263,-7.1826,-7.1206,2
"6569",1,19,15,-4,-15.3647072894397,-1.1826,-0.1206,1
"6570",1,25,26,1,-16.4796668775113,-6.1826,-11.1206,7
"6571",1,16,25,9,-5.31362831193756,-14.1826,-10.1206,-2
"6572",1,15,29,14,-1.49672739249183,-19.1826,-14.1206,-3
"6573",1,18,16,-2,-13.3857218903537,-3.1826,-1.1206,0
"6574",1,18,7,-11,-18.7293768473189,5.8174,7.8794,0
"6575",1,16,5,-11,-17.5441632595345,5.8174,9.8794,-2
"6576",1,17,11,-6,-15.066762053087,0.8174,3.8794,-1
"6577",1,17,10,-7,-15.8371067328986,1.8174,4.8794,-1
"6578",1,24,9,-15,-25.1329585061173,9.8174,5.8794,6
"6579",1,23,29,6,-11.8959466478313,-11.1826,-14.1206,5
"6580",1,17,19,2,-10.3405175712835,-7.1826,-4.1206,-1
"6581",1,22,20,-2,-16.2558777132909,-3.1826,-5.1206,4
"6582",1,20,17,-3,-15.4269112726834,-2.1826,-2.1206,2
"6583",1,17,11,-6,-15.2153992210533,0.8174,3.8794,-1
"6584",1,22,16,-6,-18.578188490803,0.8174,-1.1206,4
"6585",1,16,23,7,-6.58369183813268,-12.1826,-8.1206,-2
"6586",1,26,9,-17,-27.8418533884026,11.8174,5.8794,8
"6587",1,20,0,-20,-25.4057416969071,14.8174,14.8794,2
"6588",1,20,10,-10,-19.7414906893404,4.8174,4.8794,2
"6589",1,34,10,-24,-37.5095320220944,18.8174,4.8794,16
"6590",1,20,21,1,-12.8521447965912,-6.1826,-6.1206,2
"6591",1,26,22,-4,-20.0142227542924,-1.1826,-7.1206,8
"6592",1,22,0,-22,-28.0253379692462,16.8174,14.8794,4
"6593",1,23,9,-14,-23.9007279775586,8.8174,5.8794,5
"6594",1,17,5,-12,-18.5821146920167,6.8174,9.8794,-1
"6595",1,25,6,-19,-28.4198600340439,13.8174,8.8794,7
"6596",1,24,10,-14,-24.7529361660921,8.8174,4.8794,6
"6597",1,24,27,3,-14.6285595161182,-8.1826,-12.1206,6
"6598",1,15,7,-8,-14.9122899247429,2.8174,7.8794,-3
"6599",1,17,9,-8,-16.2487203969211,2.8174,5.8794,-1
"6600",1,20,3,-17,-23.6476760198828,11.8174,11.8794,2
"6601",1,23,3,-20,-27.8344311595356,14.8174,11.8794,5
"6602",1,13,11,-2,-9.94292215356129,-3.1826,3.8794,-5
"6603",1,18,25,7,-7.55308022062851,-12.1826,-10.1206,0
"6604",1,28,9,-19,-30.7058656781332,13.8174,5.8794,10
"6605",1,15,30,15,-1.37242746484184,-20.1826,-15.1206,-3
"6606",1,21,26,5,-11.2132017038363,-10.1826,-11.1206,3
"6607",1,17,9,-8,-16.0605534371977,2.8174,5.8794,-1
"6608",1,16,22,6,-7.12214041049179,-11.1826,-7.1206,-2
"6609",1,23,25,2,-14.3045303805042,-7.1826,-10.1206,5
"6610",1,17,12,-5,-14.5374258439037,-0.1826,2.8794,-1
"6611",1,24,0,-24,-30.6398483788966,18.8174,14.8794,6
"6612",1,15,6,-9,-15.505408779079,3.8174,8.8794,-3
"6613",1,19,1,-18,-23.4337072892565,12.8174,13.8794,1
"6614",1,21,19,-2,-15.2876669259694,-3.1826,-4.1206,3
"6615",1,30,9,-21,-33.209868251164,15.8174,5.8794,12
"6616",1,20,25,5,-10.146880893181,-10.1826,-10.1206,2
"6617",1,26,12,-14,-26.2278659338584,8.8174,2.8794,8
"6618",1,24,1,-23,-30.1707212627651,17.8174,13.8794,6
"6619",1,13,14,1,-8.0383918035713,-6.1826,0.8794,-5
"6620",1,22,17,-5,-17.8896672327504,-0.1826,-2.1206,4
"6621",1,20,16,-4,-16.0134263743117,-1.1826,-1.1206,2
"6622",1,13,29,16,0.811059057077976,-21.1826,-14.1206,-5
"6623",1,20,15,-5,-16.6148748306671,-0.1826,-0.1206,2
"6624",1,28,0,-28,-35.9304184826003,22.8174,14.8794,10
"6625",1,15,20,5,-7.02243304365615,-10.1826,-5.1206,-3
"6626",1,19,22,3,-10.6932433652993,-8.1826,-7.1206,1
"6627",1,24,3,-21,-28.7679829281875,15.8174,11.8794,6
"6628",1,24,9,-15,-25.513854230056,9.8174,5.8794,6
"6629",1,21,6,-15,-23.2005759823635,9.8174,8.8794,3
"6630",1,26,28,2,-16.7790132582766,-7.1826,-13.1206,8
"6631",1,24,10,-14,-24.7568182263282,8.8174,4.8794,6
"6632",1,21,16,-5,-17.0184815956048,-0.1826,-1.1206,3
"6633",1,25,25,0,-16.9294509307706,-5.1826,-10.1206,7
"6634",1,20,4,-16,-22.8543010381674,10.8174,10.8794,2
"6635",1,21,1,-20,-26.143142859778,14.8174,13.8794,3
"6636",1,18,25,7,-7.97981169687199,-12.1826,-10.1206,0
"6637",1,15,11,-4,-12.2580613348156,-1.1826,3.8794,-3
"6638",1,24,7,-17,-26.6304662506263,11.8174,7.8794,6
"6639",1,22,9,-13,-22.6340609187164,7.8174,5.8794,4
"6640",1,20,26,6,-10.1342715162274,-11.1826,-11.1206,2
"6641",1,17,0,-17,-21.5565843321136,11.8174,14.8794,-1
"6642",1,20,6,-14,-21.9499887888691,8.8174,8.8794,2
"6643",1,19,17,-2,-13.8154328358983,-3.1826,-2.1206,1
"6644",1,20,22,2,-12.2609706516757,-7.1826,-7.1206,2
"6645",1,14,7,-7,-13.5929479671731,1.8174,7.8794,-4
"6646",1,21,19,-2,-15.522352363931,-3.1826,-4.1206,3
"6647",1,18,13,-5,-15.3741215390678,-0.1826,1.8794,0
"6648",1,18,13,-5,-15.106124514059,-0.1826,1.8794,0
"6649",1,20,25,5,-10.2219669383191,-10.1826,-10.1206,2
"6650",1,16,0,-16,-20.3075685725205,10.8174,14.8794,-2
"6651",1,21,21,0,-14.2236469973255,-5.1826,-6.1206,3
"6652",1,28,19,-9,-24.6704778942372,3.8174,-4.1206,10
"6653",1,24,24,0,-16.0851180301989,-5.1826,-9.1206,6
"6654",1,20,9,-11,-20.0633716612293,5.8174,5.8794,2
"6655",1,23,2,-21,-28.067925504396,15.8174,12.8794,5
"6656",1,23,7,-16,-25.4771001272696,10.8174,7.8794,5
"6657",1,18,0,-18,-22.5794886461816,12.8174,14.8794,0
"6658",1,22,15,-7,-19.1544462997249,1.8174,-0.1206,4
"6659",1,13,20,7,-4.41266039543597,-12.1826,-5.1206,-5
"6660",1,18,27,9,-6.70009742414452,-14.1826,-12.1206,0
"6661",1,20,18,-2,-14.7472830749294,-3.1826,-3.1206,2
"6662",1,20,12,-8,-18.2509817428006,2.8174,2.8794,2
"6663",1,23,7,-16,-25.5589512250002,10.8174,7.8794,5
"6664",1,22,23,1,-14.3498781473153,-6.1826,-8.1206,4
"6665",1,30,29,-1,-21.1053080884361,-4.1826,-14.1206,12
"6666",1,24,11,-13,-24.1310314759739,7.8174,3.8794,6
"6667",1,20,25,5,-10.5622476924678,-10.1826,-10.1206,2
"6668",1,15,24,9,-4.44140937748217,-14.1826,-9.1206,-3
"6669",1,17,4,-13,-19.1260156529047,7.8174,10.8794,-1
"6670",1,14,8,-6,-12.5659227489526,0.8174,6.8794,-4
"6671",1,15,26,11,-3.47610479685285,-16.1826,-11.1206,-3
"6672",1,14,15,1,-8.40915668587214,-6.1826,-0.1206,-4
"6673",1,17,25,8,-6.50698550993523,-13.1826,-10.1206,-1
"6674",1,22,11,-11,-21.6066687276083,5.8174,3.8794,4
"6675",1,18,28,10,-6.19816964684525,-15.1826,-13.1206,0
"6676",1,19,24,5,-9.90736512371674,-10.1826,-9.1206,1
"6677",1,24,13,-11,-22.7722990811021,5.8174,1.8794,6
"6678",1,23,24,1,-14.7927339813747,-6.1826,-9.1206,5
"6679",1,23,10,-13,-23.2235541480977,7.8174,4.8794,5
"6680",1,24,9,-15,-25.1576164389283,9.8174,5.8794,6
"6681",1,23,9,-14,-23.8300616800002,8.8174,5.8794,5
"6682",1,18,12,-6,-15.6569721688384,0.8174,2.8794,0
"6683",1,28,7,-21,-31.6791221884045,15.8174,7.8794,10
"6684",1,17,28,11,-4.74076151200628,-16.1826,-13.1206,-1
"6685",1,21,21,0,-14.2848634128392,-5.1826,-6.1206,3
"6686",1,19,17,-2,-13.8509736131319,-3.1826,-2.1206,1
"6687",1,25,11,-14,-25.3072762175049,8.8174,3.8794,7
"6688",1,17,17,0,-11.2033970491444,-5.1826,-2.1206,-1
"6689",1,15,28,13,-2.32037863463971,-18.1826,-13.1206,-3
"6690",1,26,17,-9,-23.2427116992226,3.8174,-2.1206,8
"6691",1,27,19,-8,-23.088603844103,2.8174,-4.1206,9
"6692",1,17,4,-13,-19.1435506086844,7.8174,10.8794,-1
"6693",1,17,15,-2,-12.4851479112269,-3.1826,-0.1206,-1
"6694",1,18,20,2,-10.8504119707637,-7.1826,-5.1206,0
"6695",1,22,25,3,-13.0663952702663,-8.1826,-10.1206,4
"6696",1,11,25,14,1.22966576134494,-19.1826,-10.1206,-7
"6697",1,19,9,-10,-18.9312297291353,4.8174,5.8794,1
"6698",1,24,16,-8,-20.9768706459801,2.8174,-1.1206,6
"6699",1,11,4,-7,-11.4258342988682,1.8174,10.8794,-7
"6700",1,20,21,1,-12.8382473695836,-6.1826,-6.1206,2
"6701",1,16,6,-10,-17.1403985262321,4.8174,8.8794,-2
"6702",1,20,16,-4,-16.0337051049782,-1.1826,-1.1206,2
"6703",1,13,30,17,1.36381291596856,-22.1826,-15.1206,-5
"6704",1,17,4,-13,-19.0173556830094,7.8174,10.8794,-1
"6705",1,20,12,-8,-18.4341535750909,2.8174,2.8794,2
"6706",1,19,1,-18,-23.6705582335309,12.8174,13.8794,1
"6707",1,19,12,-7,-17.1629365966873,1.8174,2.8794,1
"6708",1,21,1,-20,-25.9144808517423,14.8174,13.8794,3
"6709",1,14,0,-14,-17.7152929472815,8.8174,14.8794,-4
"6710",1,14,25,11,-2.76181427669183,-16.1826,-10.1206,-4
"6711",1,18,0,-18,-22.7162165265473,12.8174,14.8794,0
"6712",1,19,5,-14,-21.1891839909834,8.8174,9.8794,1
"6713",1,20,19,-1,-14.1199139477538,-4.1826,-4.1206,2
"6714",1,20,30,10,-7.5411203460408,-15.1826,-15.1206,2
"6715",1,23,0,-23,-29.324106951778,17.8174,14.8794,5
"6716",1,15,22,7,-5.58405386996719,-12.1826,-7.1206,-3
"6717",1,19,11,-8,-17.5839740973666,2.8174,3.8794,1
"6718",1,19,22,3,-10.9618322381949,-8.1826,-7.1206,1
"6719",1,29,21,-8,-24.5911459513723,2.8174,-6.1206,11
"6720",1,16,16,0,-10.9150199068605,-5.1826,-1.1206,-2
"6721",1,25,8,-17,-27.3928956205243,11.8174,6.8794,7
"6722",1,19,8,-11,-19.3403548810369,5.8174,6.8794,1
"6723",1,24,20,-4,-18.667119915621,-1.1826,-5.1206,6
"6724",1,15,25,10,-4.25730787651763,-15.1826,-10.1206,-3
"6725",1,18,12,-6,-15.7977838301013,0.8174,2.8794,0
"6726",1,17,25,8,-6.90043660055915,-13.1826,-10.1206,-1
"6727",1,14,30,16,0.10353187865681,-21.1826,-15.1206,-4
"6728",1,18,5,-13,-20.1453379999243,7.8174,9.8794,0
"6729",1,29,26,-3,-21.755772891433,-2.1826,-11.1206,11
"6730",1,24,28,4,-13.8480416291554,-9.1826,-13.1206,6
"6731",1,26,9,-17,-27.9279965013128,11.8174,5.8794,8
"6732",1,17,19,2,-10.3829019217374,-7.1826,-4.1206,-1
"6733",1,21,26,5,-11.2526617313481,-10.1826,-11.1206,3
"6734",1,22,25,3,-13.4824873457611,-8.1826,-10.1206,4
"6735",1,19,14,-5,-15.7520871275491,-0.1826,0.8794,1
"6736",1,14,25,11,-2.79891369315256,-16.1826,-10.1206,-4
"6737",1,19,28,9,-7.54134634459415,-14.1826,-13.1206,1
"6738",1,14,24,10,-3.0739350174017,-15.1826,-9.1206,-4
"6739",1,15,8,-7,-14.3711449764458,1.8174,6.8794,-3
"6740",1,19,22,3,-10.8873561397217,-8.1826,-7.1206,1
"6741",1,18,28,10,-5.94123015893386,-15.1826,-13.1206,0
"6742",1,20,11,-9,-18.7589560536715,3.8174,3.8794,2
"6743",1,24,14,-10,-22.2779585092935,4.8174,0.8794,6
"6744",1,19,2,-17,-22.8710214979896,11.8174,12.8794,1
"6745",1,19,9,-10,-18.7954930665746,4.8174,5.8794,1
"6746",1,19,26,7,-8.74646003657946,-12.1826,-11.1206,1
"6747",1,18,22,4,-9.89026328816369,-9.1826,-7.1206,0
"6748",1,17,3,-14,-19.5534175116765,8.8174,11.8794,-1
"6749",1,18,30,12,-4.86765740643855,-17.1826,-15.1206,0
"6750",1,18,27,9,-6.78927158474187,-14.1826,-12.1206,0
"6751",1,22,19,-3,-16.6644673537874,-2.1826,-4.1206,4
"6752",1,22,4,-18,-25.3698098544993,12.8174,10.8794,4
"6753",1,16,22,6,-7.22808233523803,-11.1826,-7.1206,-2
"6754",1,16,8,-8,-15.2770267732861,2.8174,6.8794,-2
"6755",1,19,2,-17,-23.2060278381331,11.8174,12.8794,1
"6756",1,22,21,-1,-15.5304697836532,-4.1826,-6.1206,4
"6757",1,18,14,-4,-14.2723689173206,-1.1826,0.8794,0
"6758",1,20,4,-16,-23.1124204475539,10.8174,10.8794,2
"6759",1,17,22,5,-8.28268799312306,-10.1826,-7.1206,-1
"6760",1,18,28,10,-6.00958686894506,-15.1826,-13.1206,0
"6761",1,20,30,10,-7.64173975442947,-15.1826,-15.1206,2
"6762",1,23,30,7,-11.0310072960137,-12.1826,-15.1206,5
"6763",1,26,15,-11,-24.426454479364,5.8174,-0.1206,8
"6764",1,22,7,-15,-23.9341363758197,9.8174,7.8794,4
"6765",1,22,14,-8,-19.716626088994,2.8174,0.8794,4
"6766",1,13,0,-13,-16.4018278553542,7.8174,14.8794,-5
"6767",1,22,2,-20,-27.0672176553637,14.8174,12.8794,4
"6768",1,15,29,14,-1.59308881172753,-19.1826,-14.1206,-3
"6769",1,22,8,-14,-23.2593793053942,8.8174,6.8794,4
"6770",1,13,28,15,0.50244662732296,-20.1826,-13.1206,-5
"6771",1,20,7,-13,-21.4053535824139,7.8174,7.8794,2
"6772",1,17,8,-9,-16.6905494040404,3.8174,6.8794,-1
"6773",1,20,21,1,-12.6757767957987,-6.1826,-6.1206,2
"6774",1,31,22,-9,-26.5965804914449,3.8174,-7.1206,13
"6775",1,20,1,-19,-24.8709424155043,13.8174,13.8794,2
"6776",1,14,27,13,-1.64249147152446,-18.1826,-12.1206,-4
"6777",1,20,20,0,-13.371906297475,-5.1826,-5.1206,2
"6778",1,28,23,-5,-22.0814083516232,-0.1826,-8.1206,10
"6779",1,23,30,7,-11.505806423474,-12.1826,-15.1206,5
"6780",1,26,19,-7,-21.8742187215513,1.8174,-4.1206,8
"6781",1,17,16,-1,-11.9392990393071,-4.1826,-1.1206,-1
"6782",1,18,18,0,-11.902585893838,-5.1826,-3.1206,0
"6783",1,19,18,-1,-13.3341664929087,-4.1826,-3.1206,1
"6784",1,22,19,-3,-17.0300615849253,-2.1826,-4.1206,4
"6785",1,16,7,-9,-16.0799282628956,3.8174,7.8794,-2
"6786",1,23,23,0,-15.510237892097,-5.1826,-8.1206,5
"6787",1,20,14,-6,-17.258798124045,0.8174,0.8794,2
"6788",1,24,6,-18,-27.0579271470916,12.8174,8.8794,6
"6789",1,15,27,12,-2.78900673279142,-17.1826,-12.1206,-3
"6790",1,26,2,-24,-32.0354511909112,18.8174,12.8794,8
"6791",1,27,17,-10,-24.4765500313483,4.8174,-2.1206,9
"6792",1,17,11,-6,-14.8901154527801,0.8174,3.8794,-1
"6793",1,22,24,2,-13.5088739355955,-7.1826,-9.1206,4
"6794",1,17,1,-16,-21.1520241410596,10.8174,13.8794,-1
"6795",1,19,0,-19,-24.3120793739669,13.8174,14.8794,1
"6796",1,21,3,-18,-24.9777694317538,12.8174,11.8794,3
"6797",1,22,5,-17,-25.4057787288005,11.8174,9.8794,4
"6798",1,26,20,-6,-21.3728808383569,0.8174,-5.1206,8
"6799",1,29,13,-16,-29.3788057459049,10.8174,1.8794,11
"6800",1,15,16,1,-9.57675269216985,-6.1826,-1.1206,-3
"6801",1,25,1,-24,-31.4615989297086,18.8174,13.8794,7
"6802",1,29,6,-23,-33.6195192170214,17.8174,8.8794,11
"6803",1,19,30,11,-6.0525333259246,-16.1826,-15.1206,1
"6804",1,17,13,-4,-13.8718059815058,-1.1826,1.8794,-1
"6805",1,18,18,0,-11.7950828650734,-5.1826,-3.1206,0
"6806",1,10,12,2,-5.10046582335562,-7.1826,2.8794,-8
"6807",1,16,10,-6,-14.1455734594384,0.8174,4.8794,-2
"6808",1,25,18,-7,-21.2085707789571,1.8174,-3.1206,7
"6809",1,20,23,3,-11.6013320941709,-8.1826,-8.1206,2
"6810",1,17,7,-10,-17.1035655987604,4.8174,7.8794,-1
"6811",1,13,26,13,-0.684319721288025,-18.1826,-11.1206,-5
"6812",1,29,26,-3,-21.69739783808,-2.1826,-11.1206,11
"6813",1,25,19,-6,-20.6017150009274,0.8174,-4.1206,7
"6814",1,19,29,10,-7.14305052739606,-15.1826,-14.1206,1
"6815",1,17,27,10,-5.34672112752757,-15.1826,-12.1206,-1
"6816",1,29,30,1,-19.3137634079375,-6.1826,-15.1206,11
"6817",1,21,2,-19,-25.7602184032838,13.8174,12.8794,3
"6818",1,24,15,-9,-21.7535689100376,3.8174,-0.1206,6
"6819",1,24,21,-3,-18.0781089318654,-2.1826,-6.1206,6
"6820",1,21,29,8,-9.52891726272548,-13.1826,-14.1206,3
"6821",1,23,22,-1,-16.111776773241,-4.1826,-7.1206,5
"6822",1,28,23,-5,-22.0285201709068,-0.1826,-8.1206,10
"6823",1,17,26,9,-5.94569316214808,-14.1826,-11.1206,-1
"6824",1,19,5,-14,-21.229457921393,8.8174,9.8794,1
"6825",1,23,12,-11,-22.2538184455669,5.8174,2.8794,5
"6826",1,25,4,-21,-29.8168418113894,15.8174,10.8794,7
"6827",1,22,20,-2,-15.9356950425853,-3.1826,-5.1206,4
"6828",1,14,11,-3,-11.2153945062173,-2.1826,3.8794,-4
"6829",1,25,4,-21,-29.5861715671217,15.8174,10.8794,7
"6830",1,19,6,-13,-20.5538467224385,7.8174,8.8794,1
"6831",1,13,6,-7,-12.7874150960135,1.8174,8.8794,-5
"6832",1,17,12,-5,-14.4816380178223,-0.1826,2.8794,-1
"6833",1,13,27,14,-0.29645341562984,-19.1826,-12.1206,-5
"6834",1,27,23,-4,-20.916489649799,-1.1826,-8.1206,9
"6835",1,16,15,-1,-11.3086651248184,-4.1826,-0.1206,-2
"6836",1,13,9,-4,-11.0418163826079,-1.1826,5.8794,-5
"6837",1,21,25,4,-11.7997575694427,-9.1826,-10.1206,3
"6838",1,14,8,-6,-12.7842934549602,0.8174,6.8794,-4
"6839",1,17,16,-1,-12.0032609561467,-4.1826,-1.1206,-1
"6840",1,19,12,-7,-17.1344136904701,1.8174,2.8794,1
"6841",1,30,17,-13,-28.3409023375384,7.8174,-2.1206,12
"6842",1,17,27,10,-5.47630308142497,-15.1826,-12.1206,-1
"6843",1,17,1,-16,-20.9805960046205,10.8174,13.8794,-1
"6844",1,21,29,8,-9.51616258779613,-13.1826,-14.1206,3
"6845",1,20,0,-20,-25.3801772310142,14.8174,14.8794,2
"6846",1,22,15,-7,-19.3363455417354,1.8174,-0.1206,4
"6847",1,11,1,-10,-13.144046300719,4.8174,13.8794,-7
"6848",1,21,30,9,-8.97791285861423,-14.1826,-15.1206,3
"6849",1,23,17,-6,-19.3400433658426,0.8174,-2.1206,5
"6850",1,24,29,5,-13.1758332991373,-10.1826,-14.1206,6
"6851",1,28,30,2,-18.2319153279781,-7.1826,-15.1206,10
"6852",1,27,29,2,-17.1322856427929,-7.1826,-14.1206,9
"6853",1,13,2,-11,-15.2429923730457,5.8174,12.8794,-5
"6854",1,20,3,-17,-23.6231974190617,11.8174,11.8794,2
"6855",1,29,22,-7,-23.8391920442196,1.8174,-7.1206,11
"6856",1,18,8,-10,-17.9605125793422,4.8174,6.8794,0
"6857",1,19,21,2,-11.5239076649005,-7.1826,-6.1206,1
"6858",1,26,8,-18,-28.5997756870891,12.8174,6.8794,8
"6859",1,22,26,4,-12.7376409465657,-9.1826,-11.1206,4
"6860",1,18,24,6,-8.3498722672456,-11.1826,-9.1206,0
"6861",1,17,6,-11,-17.7447054987274,5.8174,8.8794,-1
"6862",1,28,7,-21,-31.6821742272263,15.8174,7.8794,10
"6863",1,22,25,3,-13.295460799474,-8.1826,-10.1206,4
"6864",1,22,21,-1,-15.7314470727879,-4.1826,-6.1206,4
"6865",1,17,9,-8,-16.3569625332118,2.8174,5.8794,-1
"6866",1,21,28,7,-9.90362143514804,-12.1826,-13.1206,3
"6867",1,12,5,-7,-12.0906119396028,1.8174,9.8794,-6
"6868",1,24,21,-3,-17.9968406876978,-2.1826,-6.1206,6
"6869",1,12,26,14,0.608735714479235,-19.1826,-11.1206,-6
"6870",1,26,17,-9,-23.0130264898435,3.8174,-2.1206,8
"6871",1,22,26,4,-12.4965589421022,-9.1826,-11.1206,4
"6872",1,18,19,1,-11.2741858170775,-6.1826,-4.1206,0
"6873",1,17,9,-8,-16.406017012397,2.8174,5.8794,-1
"6874",1,22,2,-20,-26.834432741037,14.8174,12.8794,4
"6875",1,13,11,-2,-9.64427599578397,-3.1826,3.8794,-5
"6876",1,21,3,-18,-24.8662281240602,12.8174,11.8794,3
"6877",1,24,1,-23,-30.1435074751565,17.8174,13.8794,6
"6878",1,24,2,-22,-29.3488343543188,16.8174,12.8794,6
"6879",1,19,13,-6,-16.4654434259818,0.8174,1.8794,1
"6880",1,20,30,10,-7.74575365828699,-15.1826,-15.1206,2
"6881",1,23,7,-16,-24.980845746103,10.8174,7.8794,5
"6882",1,20,9,-11,-20.223341037166,5.8174,5.8794,2
"6883",1,16,17,1,-10.0238170801249,-6.1826,-2.1206,-2
"6884",1,18,7,-11,-18.3157271373192,5.8174,7.8794,0
"6885",1,23,11,-12,-22.7444014346334,6.8174,3.8794,5
"6886",1,24,30,6,-12.6509264551866,-11.1826,-15.1206,6
"6887",1,16,1,-15,-19.7241407799455,9.8174,13.8794,-2
"6888",1,21,24,3,-12.1514455380457,-8.1826,-9.1206,3
"6889",1,18,27,9,-6.65793717705682,-14.1826,-12.1206,0
"6890",1,19,23,4,-10.4154492386588,-9.1826,-8.1206,1
"6891",1,22,26,4,-12.6473672288265,-9.1826,-11.1206,4
"6892",1,20,4,-16,-22.9492802005734,10.8174,10.8794,2
"6893",1,19,24,5,-9.76531494439356,-10.1826,-9.1206,1
"6894",1,18,27,9,-6.62190577889233,-14.1826,-12.1206,0
"6895",1,32,21,-11,-28.4945356807513,5.8174,-6.1206,14
"6896",1,20,6,-14,-21.8042406228705,8.8174,8.8794,2
"6897",1,13,11,-2,-10.1073985759802,-3.1826,3.8794,-5
"6898",1,20,11,-9,-18.9180122122442,3.8174,3.8794,2
"6899",1,15,30,15,-1.10710512765671,-20.1826,-15.1206,-3
"6900",1,12,6,-6,-11.3557117165675,0.8174,8.8794,-6
"6901",1,19,18,-1,-13.4203719414661,-4.1826,-3.1206,1
"6902",1,21,24,3,-12.1143873827068,-8.1826,-9.1206,3
"6903",1,14,4,-10,-15.2611422285092,4.8174,10.8794,-4
"6904",1,21,27,6,-10.4442260423036,-11.1826,-12.1206,3
"6905",1,20,25,5,-10.6486864603372,-10.1826,-10.1206,2
"6906",1,16,26,10,-4.60399351343308,-15.1826,-11.1206,-2
"6907",1,16,6,-10,-16.7244061286198,4.8174,8.8794,-2
"6908",1,15,7,-8,-14.8369079503154,2.8174,7.8794,-3
"6909",1,19,12,-7,-16.9529923141563,1.8174,2.8794,1
"6910",1,20,20,0,-13.4151757945876,-5.1826,-5.1206,2
"6911",1,30,26,-4,-23.1600078264233,-1.1826,-11.1206,12
"6912",1,16,5,-11,-17.2408767024718,5.8174,9.8794,-2
"6913",1,12,4,-8,-12.7055724674671,2.8174,10.8794,-6
"6914",1,17,3,-14,-19.8607595180161,8.8174,11.8794,-1
"6915",1,22,5,-17,-25.077867701835,11.8174,9.8794,4
"6916",1,17,13,-4,-13.9407979264271,-1.1826,1.8794,-1
"6917",1,30,16,-14,-28.7319341582578,8.8174,-1.1206,12
"6918",1,16,21,5,-7.64644993392502,-10.1826,-6.1206,-2
"6919",1,20,13,-7,-17.7987296596697,1.8174,1.8794,2
"6920",1,23,20,-3,-17.2456917073504,-2.1826,-5.1206,5
"6921",1,19,23,4,-10.5165935251766,-9.1826,-8.1206,1
"6922",1,21,29,8,-9.29958980108133,-13.1826,-14.1206,3
"6923",1,19,8,-11,-19.4612868520098,5.8174,6.8794,1
"6924",1,23,20,-3,-17.3408311470652,-2.1826,-5.1206,5
"6925",1,16,15,-1,-11.4262008667409,-4.1826,-0.1206,-2
"6926",1,26,14,-12,-24.8361509508161,6.8174,0.8794,8
"6927",1,22,9,-13,-22.7116077396038,7.8174,5.8794,4
"6928",1,20,8,-12,-20.7571178002036,6.8174,6.8794,2
"6929",1,22,29,7,-10.4820122363192,-12.1826,-14.1206,4
"6930",1,17,22,5,-8.53222680846087,-10.1826,-7.1206,-1
"6931",1,12,11,-1,-8.4707439074904,-4.1826,3.8794,-6
"6932",1,22,27,5,-11.8499574024264,-10.1826,-12.1206,4
"6933",1,18,6,-12,-19.462771900604,6.8174,8.8794,0
"6934",1,27,8,-19,-30.0312079830412,13.8174,6.8794,9
"6935",1,20,10,-10,-19.2718280215416,4.8174,4.8794,2
"6936",1,18,29,11,-5.45777431296779,-16.1826,-14.1206,0
"6937",1,18,3,-15,-20.7894357103721,9.8174,11.8794,0
"6938",1,15,10,-5,-13.116919855406,-0.1826,4.8794,-3
"6939",1,15,0,-15,-19.2304330744841,9.8174,14.8794,-3
"6940",1,21,18,-3,-15.9507340936623,-2.1826,-3.1206,3
"6941",1,20,26,6,-9.87333653835273,-11.1826,-11.1206,2
"6942",1,25,15,-10,-22.7514253974716,4.8174,-0.1206,7
"6943",1,17,0,-17,-21.6802951904201,11.8174,14.8794,-1
"6944",1,21,0,-21,-26.6359330311776,15.8174,14.8794,3
"6945",1,16,30,14,-2.39064798708173,-19.1826,-15.1206,-2
"6946",1,23,23,0,-15.5843450903703,-5.1826,-8.1206,5
"6947",1,28,24,-4,-21.7464953316184,-1.1826,-9.1206,10
"6948",1,18,7,-11,-18.5076912560956,5.8174,7.8794,0
"6949",1,25,26,1,-16.2197915068179,-6.1826,-11.1206,7
"6950",1,13,25,12,-1.59308871489,-17.1826,-10.1206,-5
"6951",1,23,16,-7,-19.7285002816566,1.8174,-1.1206,5
"6952",1,19,18,-1,-13.4997359993827,-4.1826,-3.1206,1
"6953",1,22,11,-11,-21.6964778811552,5.8174,3.8794,4
"6954",1,26,14,-12,-24.9121783092959,6.8174,0.8794,8
"6955",1,25,18,-7,-21.2536803158787,1.8174,-3.1206,7
"6956",1,23,15,-8,-20.6062419978081,2.8174,-0.1206,5
"6957",1,17,17,0,-11.5031180856505,-5.1826,-2.1206,-1
"6958",1,19,29,10,-6.85885991788301,-15.1826,-14.1206,1
"6959",1,28,26,-2,-20.194591399636,-3.1826,-11.1206,10
"6960",1,16,7,-9,-16.0760963835898,3.8174,7.8794,-2
"6961",1,17,29,12,-4.44303145602628,-17.1826,-14.1206,-1
"6962",1,18,7,-11,-18.5632633908777,5.8174,7.8794,0
"6963",1,18,14,-4,-14.3274861431191,-1.1826,0.8794,0
"6964",1,22,25,3,-13.029507453442,-8.1826,-10.1206,4
"6965",1,23,22,-1,-16.4563288664745,-4.1826,-7.1206,5
"6966",1,17,8,-9,-16.7906925383635,3.8174,6.8794,-1
"6967",1,15,19,4,-7.55545627661205,-9.1826,-4.1206,-3
"6968",1,14,12,-2,-10.4682184544941,-3.1826,2.8794,-4
"6969",1,28,30,2,-17.9516723300206,-7.1826,-15.1206,10
"6970",1,16,30,14,-2.30157147658881,-19.1826,-15.1206,-2
"6971",1,23,24,1,-14.6958726931538,-6.1826,-9.1206,5
"6972",1,20,26,6,-10.0930772660735,-11.1826,-11.1206,2
"6973",1,21,30,9,-8.63846434626574,-14.1826,-15.1206,3
"6974",1,17,20,3,-9.76882001670829,-8.1826,-5.1206,-1
"6975",1,14,6,-8,-14.0638145740493,2.8174,8.8794,-4
"6976",1,23,11,-12,-23.1534365407619,6.8174,3.8794,5
"6977",1,14,18,4,-6.89596809547594,-9.1826,-3.1206,-4
"6978",1,21,23,2,-13.0436667277434,-7.1826,-8.1206,3
"6979",1,20,9,-11,-20.1400910010942,5.8174,5.8794,2
"6980",1,18,11,-7,-16.404413977228,1.8174,3.8794,0
"6981",1,22,11,-11,-21.4985210594579,5.8174,3.8794,4
"6982",1,16,10,-6,-14.0957314756304,0.8174,4.8794,-2
"6983",1,22,20,-2,-16.0298885032108,-3.1826,-5.1206,4
"6984",1,19,27,8,-7.9501711695051,-13.1826,-12.1206,1
"6985",1,20,19,-1,-14.3786427216682,-4.1826,-4.1206,2
"6986",1,22,25,3,-13.0330603938628,-8.1826,-10.1206,4
"6987",1,19,17,-2,-14.0176597351884,-3.1826,-2.1206,1
"6988",1,14,28,14,-0.959011314315786,-19.1826,-13.1206,-4
"6989",1,14,23,9,-3.80071331131747,-14.1826,-8.1206,-4
"6990",1,27,8,-19,-29.5066507267009,13.8174,6.8794,9
"6991",1,21,5,-16,-23.5785688655926,10.8174,9.8794,3
"6992",1,18,10,-8,-16.7440189853212,2.8174,4.8794,0
"6993",1,22,22,0,-15.0829903393309,-5.1826,-7.1206,4
"6994",1,21,9,-12,-21.5669760766321,6.8174,5.8794,3
"6995",1,26,16,-10,-23.7264677730117,4.8174,-1.1206,8
"6996",1,24,2,-22,-29.4332802569348,16.8174,12.8794,6
"6997",1,10,25,15,2.69571626108764,-20.1826,-10.1206,-8
"6998",1,24,0,-24,-30.7924945250493,18.8174,14.8794,6
"6999",1,21,21,0,-14.0980048777243,-5.1826,-6.1206,3
"7000",1,20,24,4,-10.9950220479292,-9.1826,-9.1206,2
"7001",1,25,18,-7,-21.272878333967,1.8174,-3.1206,7
"7002",1,17,29,12,-4.15646033234351,-17.1826,-14.1206,-1
"7003",1,20,17,-3,-15.2008528628793,-2.1826,-2.1206,2
"7004",1,22,18,-4,-17.129080923157,-1.1826,-3.1206,4
"7005",1,20,27,7,-9.36227041443727,-12.1826,-12.1206,2
"7006",1,16,30,14,-2.4049384730483,-19.1826,-15.1206,-2
"7007",1,16,3,-13,-18.556547171629,7.8174,11.8794,-2
"7008",1,23,25,2,-14.5160560885268,-7.1826,-10.1206,5
"7009",1,24,13,-11,-22.9328367038407,5.8174,1.8794,6
"7010",1,21,5,-16,-23.8765530947877,10.8174,9.8794,3
"7011",1,21,2,-19,-25.8696153624512,13.8174,12.8794,3
"7012",1,17,2,-15,-20.2196004322149,9.8174,12.8794,-1
"7013",1,13,16,3,-6.67514417734961,-8.1826,-1.1206,-5
"7014",1,21,9,-12,-21.4140132473979,6.8174,5.8794,3
"7015",1,19,15,-4,-15.0883912247865,-1.1826,-0.1206,1
"7016",1,19,9,-10,-18.8386306340249,4.8174,5.8794,1
"7017",1,17,2,-15,-20.4412394122068,9.8174,12.8794,-1
"7018",1,21,23,2,-13.2314648600996,-7.1826,-8.1206,3
"7019",1,22,16,-6,-18.7958435249632,0.8174,-1.1206,4
"7020",1,15,21,6,-6.57125727732647,-11.1826,-6.1206,-3
"7021",1,14,10,-4,-11.634957677652,-1.1826,4.8794,-4
"7022",1,13,13,0,-8.93340685047552,-5.1826,1.8794,-5
"7023",1,24,22,-2,-17.4122535134964,-3.1826,-7.1206,6
"7024",1,22,3,-19,-26.2764041171471,13.8174,11.8794,4
"7025",1,16,28,12,-3.4418086259106,-17.1826,-13.1206,-2
"7026",1,28,12,-16,-28.8368549350351,10.8174,2.8794,10
"7027",1,20,8,-12,-20.6288890818587,6.8174,6.8794,2
"7028",1,15,3,-12,-16.9414799295014,6.8174,11.8794,-3
"7029",1,16,9,-7,-14.8133183182438,1.8174,5.8794,-2
"7030",1,18,12,-6,-15.6594751337813,0.8174,2.8794,0
"7031",1,22,13,-9,-20.3717523930399,3.8174,1.8794,4
"7032",1,29,23,-6,-23.1622624486927,0.8174,-8.1206,11
"7033",1,22,15,-7,-19.0398452975902,1.8174,-0.1206,4
"7034",1,16,0,-16,-20.3538303014561,10.8174,14.8794,-2
"7035",1,9,13,4,-3.48565076181991,-9.1826,1.8794,-9
"7036",1,16,21,5,-7.7269254844723,-10.1826,-6.1206,-2
"7037",1,22,13,-9,-20.2560158971915,3.8174,1.8794,4
"7038",1,16,2,-14,-19.2084484801907,8.8174,12.8794,-2
"7039",1,19,17,-2,-14.0842809854157,-3.1826,-2.1206,1
"7040",1,20,10,-10,-19.825056666914,4.8174,4.8794,2
"7041",1,23,10,-13,-23.5757166520752,7.8174,4.8794,5
"7042",1,21,26,5,-11.0654988731361,-10.1826,-11.1206,3
"7043",1,19,18,-1,-13.2805370673937,-4.1826,-3.1206,1
"7044",1,23,13,-10,-21.5973974154951,4.8174,1.8794,5
"7045",1,16,14,-2,-11.9595013550079,-3.1826,0.8794,-2
"7046",1,14,26,12,-1.84271614510389,-17.1826,-11.1206,-4
"7047",1,11,0,-11,-13.7263430115384,5.8174,14.8794,-7
"7048",1,22,6,-16,-24.6491750610031,10.8174,8.8794,4
"7049",1,24,20,-4,-18.6111393577412,-1.1826,-5.1206,6
"7050",1,14,13,-1,-9.81713701750846,-4.1826,1.8794,-4
"7051",1,21,6,-15,-23.2917812414163,9.8174,8.8794,3
"7052",1,19,24,5,-10.0006523407193,-10.1826,-9.1206,1
"7053",1,25,21,-4,-19.6343311405133,-1.1826,-6.1206,7
"7054",1,14,27,13,-1.38314099610574,-18.1826,-12.1206,-4
"7055",1,24,1,-23,-30.003842538695,17.8174,13.8794,6
"7056",1,22,29,7,-10.7585738863712,-12.1826,-14.1206,4
"7057",1,16,15,-1,-11.2601758758787,-4.1826,-0.1206,-2
"7058",1,20,22,2,-12.0240971517304,-7.1826,-7.1206,2
"7059",1,22,14,-8,-19.5641534982598,2.8174,0.8794,4
"7060",1,18,14,-4,-14.5453635877386,-1.1826,0.8794,0
"7061",1,29,29,0,-19.6985320756634,-5.1826,-14.1206,11
"7062",1,17,0,-17,-21.4878470157011,11.8174,14.8794,-1
"7063",1,26,11,-15,-26.7229269822003,9.8174,3.8794,8
"7064",1,28,1,-27,-35.2557840991309,21.8174,13.8794,10
"7065",1,14,0,-14,-17.6161209925507,8.8174,14.8794,-4
"7066",1,19,11,-8,-17.4682749162615,2.8174,3.8794,1
"7067",1,27,23,-4,-20.7673141007568,-1.1826,-8.1206,9
"7068",1,25,5,-20,-29.0690954704575,14.8174,9.8794,7
"7069",1,18,10,-8,-17.0171012315342,2.8174,4.8794,0
"7070",1,25,2,-23,-30.8097627504125,17.8174,12.8794,7
"7071",1,16,20,4,-8.28078793614226,-9.1826,-5.1206,-2
"7072",1,22,23,1,-14.2888296523952,-6.1826,-8.1206,4
"7073",1,24,21,-3,-17.9263422504619,-2.1826,-6.1206,6
"7074",1,28,4,-24,-33.5719702483237,18.8174,10.8794,10
"7075",1,18,21,3,-10.4122884224499,-8.1826,-6.1206,0
"7076",1,23,6,-17,-25.8224344534089,11.8174,8.8794,5
"7077",1,25,29,4,-14.6941247797085,-9.1826,-14.1206,7
"7078",1,16,1,-15,-19.5394969088523,9.8174,13.8794,-2
"7079",1,17,7,-10,-17.447873659601,4.8174,7.8794,-1
"7080",1,18,15,-3,-13.828155124382,-2.1826,-0.1206,0
"7081",1,20,25,5,-10.7184155979897,-10.1826,-10.1206,2
"7082",1,20,1,-19,-25.2127987190466,13.8174,13.8794,2
"7083",1,18,24,6,-8.74518039893822,-11.1826,-9.1206,0
"7084",1,21,24,3,-12.6768627543984,-8.1826,-9.1206,3
"7085",1,23,23,0,-15.6199937654935,-5.1826,-8.1206,5
"7086",1,17,12,-5,-14.4469703439921,-0.1826,2.8794,-1
"7087",1,20,24,4,-10.9910930039558,-9.1826,-9.1206,2
"7088",1,14,26,12,-1.79893682304674,-17.1826,-11.1206,-4
"7089",1,25,12,-13,-24.8431360746576,7.8174,2.8794,7
"7090",1,26,15,-11,-24.0920868263134,5.8174,-0.1206,8
"7091",1,29,28,-1,-20.0546169660792,-4.1826,-13.1206,11
"7092",1,16,25,9,-5.51859167352873,-14.1826,-10.1206,-2
"7093",1,18,6,-12,-19.3779655540063,6.8174,8.8794,0
"7094",1,16,13,-3,-12.3579626249528,-2.1826,1.8794,-2
"7095",1,24,6,-18,-27.0597112396937,12.8174,8.8794,6
"7096",1,20,30,10,-7.40328070652294,-15.1826,-15.1206,2
"7097",1,16,8,-8,-15.2194952516511,2.8174,6.8794,-2
"7098",1,18,21,3,-10.4530281772037,-8.1826,-6.1206,0
"7099",1,26,12,-14,-26.2448620618316,8.8174,2.8794,8
"7100",1,23,18,-5,-18.6921329260597,-0.1826,-3.1206,5
"7101",1,25,2,-23,-30.6893355525206,17.8174,12.8794,7
"7102",1,21,30,9,-8.40298507813451,-14.1826,-15.1206,3
"7103",1,21,2,-19,-25.7818290077387,13.8174,12.8794,3
"7104",1,11,23,12,-0.205515018430718,-17.1826,-8.1206,-7
"7105",1,22,4,-18,-25.6351986382283,12.8174,10.8794,4
"7106",1,22,22,0,-14.7141453605972,-5.1826,-7.1206,4
"7107",1,17,9,-8,-16.1968406408524,2.8174,5.8794,-1
"7108",1,30,20,-10,-26.5599286868858,4.8174,-5.1206,12
"7109",1,21,30,9,-8.82603656550549,-14.1826,-15.1206,3
"7110",1,17,2,-15,-20.5183014514939,9.8174,12.8794,-1
"7111",1,14,16,2,-8.36758923550175,-7.1826,-1.1206,-4
"7112",1,21,6,-15,-23.2941367770228,9.8174,8.8794,3
"7113",1,20,10,-10,-19.3298634813154,4.8174,4.8794,2
"7114",1,21,26,5,-11.2204333980765,-10.1826,-11.1206,3
"7115",1,23,16,-7,-19.937992317734,1.8174,-1.1206,5
"7116",1,16,12,-4,-13.2024582088593,-1.1826,2.8794,-2
"7117",1,21,9,-12,-21.4043989415212,6.8174,5.8794,3
"7118",1,19,11,-8,-17.6378119106119,2.8174,3.8794,1
"7119",1,15,16,1,-9.44834434867635,-6.1826,-1.1206,-3
"7120",1,14,21,7,-5.19656206434709,-12.1826,-6.1206,-4
"7121",1,27,10,-17,-28.7357354888425,11.8174,4.8794,9
"7122",1,33,16,-17,-32.8126775015498,11.8174,-1.1206,15
"7123",1,14,14,0,-9.12949414410448,-5.1826,0.8794,-4
"7124",1,24,4,-20,-28.2956929540298,14.8174,10.8794,6
"7125",1,22,9,-13,-22.7583809020975,7.8174,5.8794,4
"7126",1,25,14,-11,-23.8264730051138,5.8174,0.8794,7
"7127",1,18,29,11,-5.39735984243182,-16.1826,-14.1206,0
"7128",1,16,6,-10,-16.5852957634628,4.8174,8.8794,-2
"7129",1,14,12,-2,-10.3451510484452,-3.1826,2.8794,-4
"7130",1,18,5,-13,-19.9749931623011,7.8174,9.8794,0
"7131",1,23,11,-12,-22.794799959913,6.8174,3.8794,5
"7132",1,19,30,11,-5.97165459489942,-16.1826,-15.1206,1
"7133",1,16,15,-1,-11.5690513628847,-4.1826,-0.1206,-2
"7134",1,16,7,-9,-16.2407142320954,3.8174,7.8794,-2
"7135",1,19,21,2,-11.4548794659376,-7.1826,-6.1206,1
"7136",1,19,0,-19,-23.831330556282,13.8174,14.8794,1
"7137",1,26,22,-4,-20.0086933127569,-1.1826,-7.1206,8
"7138",1,22,15,-7,-19.2953034200157,1.8174,-0.1206,4
"7139",1,12,23,11,-1.39665404893915,-16.1826,-8.1206,-6
"7140",1,22,10,-12,-22.0609179721856,6.8174,4.8794,4
"7141",1,27,17,-10,-24.3367333122275,4.8174,-2.1206,9
"7142",1,22,21,-1,-15.4723493747056,-4.1826,-6.1206,4
"7143",1,25,10,-15,-26.1130227555467,9.8174,4.8794,7
"7144",1,22,11,-11,-21.6527182766124,5.8174,3.8794,4
"7145",1,20,24,4,-11.0280249430393,-9.1826,-9.1206,2
"7146",1,19,8,-11,-19.2684478801632,5.8174,6.8794,1
"7147",1,24,9,-15,-25.2597026149025,9.8174,5.8794,6
"7148",1,25,13,-12,-24.3100496687616,6.8174,1.8794,7
"7149",1,13,28,15,0.359281592648306,-20.1826,-13.1206,-5
"7150",1,27,14,-13,-26.1275957122088,7.8174,0.8794,9
"7151",1,20,24,4,-11.2141158488606,-9.1826,-9.1206,2
"7152",1,17,21,4,-9.02935887380029,-9.1826,-6.1206,-1
"7153",1,20,12,-8,-18.301771578565,2.8174,2.8794,2
"7154",1,23,18,-5,-18.6977025840863,-0.1826,-3.1206,5
"7155",1,23,29,6,-12.0424734857451,-11.1826,-14.1206,5
"7156",1,23,13,-10,-21.7470890650739,4.8174,1.8794,5
"7157",1,23,9,-14,-23.973594161665,8.8174,5.8794,5
"7158",1,22,19,-3,-16.7078913295972,-2.1826,-4.1206,4
"7159",1,17,13,-4,-13.7651172826992,-1.1826,1.8794,-1
"7160",1,30,13,-17,-30.8808199982214,11.8174,1.8794,12
"7161",1,18,13,-5,-15.1925479606362,-0.1826,1.8794,0
"7162",1,21,10,-11,-20.8911508501118,5.8174,4.8794,3
"7163",1,25,11,-14,-25.5551324244969,8.8174,3.8794,7
"7164",1,18,19,1,-11.4473599830771,-6.1826,-4.1206,0
"7165",1,15,10,-5,-13.1027621868698,-0.1826,4.8794,-3
"7166",1,16,26,10,-4.98138242600282,-15.1826,-11.1206,-2
"7167",1,14,18,4,-6.75350663703037,-9.1826,-3.1206,-4
"7168",1,17,23,6,-7.82661784782615,-11.1826,-8.1206,-1
"7169",1,24,16,-8,-21.133868355519,2.8174,-1.1206,6
"7170",1,23,5,-18,-26.3554537165722,12.8174,9.8794,5
"7171",1,29,11,-18,-30.8069108954918,12.8174,3.8794,11
"7172",1,11,9,-2,-8.28698884400045,-3.1826,5.8794,-7
"7173",1,19,11,-8,-17.5949806719813,2.8174,3.8794,1
"7174",1,24,1,-23,-29.9288690392344,17.8174,13.8794,6
"7175",1,17,21,4,-9.02390938403553,-9.1826,-6.1206,-1
"7176",1,17,7,-10,-17.4613781860019,4.8174,7.8794,-1
"7177",1,21,8,-13,-21.797349719717,7.8174,6.8794,3
"7178",1,13,3,-10,-14.4727882000134,4.8174,11.8794,-5
"7179",1,16,12,-4,-13.1797116741539,-1.1826,2.8794,-2
"7180",1,17,8,-9,-16.7939642332181,3.8174,6.8794,-1
"7181",1,21,8,-13,-22.0058087777426,7.8174,6.8794,3
"7182",1,23,27,4,-13.0693061985479,-9.1826,-12.1206,5
"7183",1,22,11,-11,-21.659335847288,5.8174,3.8794,4
"7184",1,18,25,7,-7.86154601252655,-12.1826,-10.1206,0
"7185",1,18,18,0,-11.9206911417753,-5.1826,-3.1206,0
"7186",1,20,0,-20,-25.7695956702553,14.8174,14.8794,2
"7187",1,20,8,-12,-20.8077065250476,6.8174,6.8794,2
"7188",1,14,1,-13,-16.9431267979058,7.8174,13.8794,-4
"7189",1,18,18,0,-11.8778269843769,-5.1826,-3.1206,0
"7190",1,26,28,2,-16.6343544912148,-7.1826,-13.1206,8
"7191",1,25,11,-14,-25.525133035131,8.8174,3.8794,7
"7192",1,19,8,-11,-19.3670938919581,5.8174,6.8794,1
"7193",1,11,23,12,-0.0237522029269246,-17.1826,-8.1206,-7
"7194",1,21,1,-20,-26.2431301234169,14.8174,13.8794,3
"7195",1,22,6,-16,-24.3190349673156,10.8174,8.8794,4
"7196",1,30,2,-28,-37.2497048838075,22.8174,12.8794,12
"7197",1,18,25,7,-7.94662007489986,-12.1826,-10.1206,0
"7198",1,11,2,-9,-12.6763793988,3.8174,12.8794,-7
"7199",1,16,2,-14,-19.2926024347324,8.8174,12.8794,-2
"7200",1,17,5,-12,-18.5551712203394,6.8174,9.8794,-1
"7201",1,25,0,-25,-31.9136180589737,19.8174,14.8794,7
"7202",1,19,6,-13,-20.4662061236657,7.8174,8.8794,1
"7203",1,18,14,-4,-14.8689285308387,-1.1826,0.8794,0
"7204",1,23,1,-22,-28.6127247250628,16.8174,13.8794,5
"7205",1,29,15,-14,-28.2660292329324,8.8174,-0.1206,11
"7206",1,18,17,-1,-12.7073972620841,-4.1826,-2.1206,0
"7207",1,20,10,-10,-19.2385561806241,4.8174,4.8794,2
"7208",1,17,0,-17,-21.5418115058806,11.8174,14.8794,-1
"7209",1,22,24,2,-13.7645616208484,-7.1826,-9.1206,4
"7210",1,15,22,7,-5.73108986584397,-12.1826,-7.1206,-3
"7211",1,12,1,-11,-14.4784132114236,5.8174,13.8794,-6
"7212",1,15,4,-11,-16.639786318212,5.8174,10.8794,-3
"7213",1,29,14,-15,-28.7954663395503,9.8174,0.8794,11
"7214",1,28,9,-19,-30.5485204299131,13.8174,5.8794,10
"7215",1,9,27,18,4.84924206696988,-23.1826,-12.1206,-9
"7216",1,25,16,-9,-22.4486735188705,3.8174,-1.1206,7
"7217",1,22,7,-15,-23.9296942961812,9.8174,7.8794,4
"7218",1,9,19,10,0.196359883037546,-15.1826,-4.1206,-9
"7219",1,28,17,-11,-25.4494262419789,5.8174,-2.1206,10
"7220",1,19,15,-4,-15.2686709917757,-1.1826,-0.1206,1
"7221",1,19,17,-2,-13.8840473922666,-3.1826,-2.1206,1
"7222",1,20,11,-9,-18.9758769603722,3.8174,3.8794,2
"7223",1,25,8,-17,-27.1648257016527,11.8174,6.8794,7
"7224",1,19,5,-14,-21.1857023300736,8.8174,9.8794,1
"7225",1,12,16,4,-5.53619439010873,-9.1826,-1.1206,-6
"7226",1,17,13,-4,-13.7099596623555,-1.1826,1.8794,-1
"7227",1,22,28,6,-11.0913003067244,-11.1826,-13.1206,4
"7228",1,19,15,-4,-14.8719976846172,-1.1826,-0.1206,1
"7229",1,20,18,-2,-14.6553947343436,-3.1826,-3.1206,2
"7230",1,15,13,-2,-11.0095150780924,-3.1826,1.8794,-3
"7231",1,15,10,-5,-13.2063307998572,-0.1826,4.8794,-3
"7232",1,20,21,1,-12.6777420583832,-6.1826,-6.1206,2
"7233",1,18,23,5,-9.16097868592299,-10.1826,-8.1206,0
"7234",1,22,13,-9,-20.2818293356071,3.8174,1.8794,4
"7235",1,17,15,-2,-12.663979511359,-3.1826,-0.1206,-1
"7236",1,21,13,-8,-19.1295130373931,2.8174,1.8794,3
"7237",1,19,28,9,-7.4844001365408,-14.1826,-13.1206,1
"7238",1,12,28,16,1.59121560358775,-21.1826,-13.1206,-6
"7239",1,30,3,-27,-36.6511069678789,21.8174,11.8794,12
"7240",1,21,29,8,-9.40795718320068,-13.1826,-14.1206,3
"7241",1,18,22,4,-9.5865212988225,-9.1826,-7.1206,0
"7242",1,22,8,-14,-23.2486167764286,8.8174,6.8794,4
"7243",1,15,18,3,-8.16321159234435,-8.1826,-3.1206,-3
"7244",1,11,13,2,-6.05835017182408,-7.1826,1.8794,-7
"7245",1,17,0,-17,-21.7319234687526,11.8174,14.8794,-1
"7246",1,24,24,0,-15.7027638825396,-5.1826,-9.1206,6
"7247",1,13,21,8,-3.86978637618038,-13.1826,-6.1206,-5
"7248",1,22,8,-14,-22.909175438615,8.8174,6.8794,4
"7249",1,23,23,0,-15.6588061232804,-5.1826,-8.1206,5
"7250",1,23,30,7,-11.4392221668306,-12.1826,-15.1206,5
"7251",1,22,25,3,-13.0437630226939,-8.1826,-10.1206,4
"7252",1,29,19,-10,-25.9468714431443,4.8174,-4.1206,11
"7253",1,25,19,-6,-20.7156403510379,0.8174,-4.1206,7
"7254",1,13,24,11,-2.08297700788667,-16.1826,-9.1206,-5
"7255",1,20,30,10,-7.42235733687746,-15.1826,-15.1206,2
"7256",1,21,13,-8,-18.8641987537662,2.8174,1.8794,3
"7257",1,22,16,-6,-18.5817872992854,0.8174,-1.1206,4
"7258",1,21,20,-1,-14.9116076252562,-4.1826,-5.1206,3
"7259",1,17,3,-14,-19.8710036675614,8.8174,11.8794,-1
"7260",1,25,19,-6,-20.5267249707343,0.8174,-4.1206,7
"7261",1,25,17,-8,-21.8827665943964,2.8174,-2.1206,7
"7262",1,18,0,-18,-22.7939595039192,12.8174,14.8794,0
"7263",1,24,30,6,-12.9360009658155,-11.1826,-15.1206,6
"7264",1,21,12,-9,-19.6349485381374,3.8174,2.8794,3
"7265",1,20,2,-18,-24.1775742265113,12.8174,12.8794,2
"7266",1,19,10,-9,-18.4796076862414,3.8174,4.8794,1
"7267",1,14,12,-2,-10.3113084502239,-3.1826,2.8794,-4
"7268",1,21,25,4,-12.0841420792515,-9.1826,-10.1206,3
"7269",1,23,21,-2,-17.1194891540008,-3.1826,-6.1206,5
"7270",1,16,8,-8,-15.5419878376051,2.8174,6.8794,-2
"7271",1,22,15,-7,-19.195354944118,1.8174,-0.1206,4
"7272",1,15,17,2,-9.06604075493745,-7.1826,-2.1206,-3
"7273",1,18,10,-8,-17.0140633356406,2.8174,4.8794,0
"7274",1,16,1,-15,-19.3717091967794,9.8174,13.8794,-2
"7275",1,26,28,2,-16.4930241619756,-7.1826,-13.1206,8
"7276",1,25,30,5,-14.0074182222716,-10.1826,-15.1206,7
"7277",1,14,2,-12,-16.3981258224041,6.8174,12.8794,-4
"7278",1,13,7,-6,-12.1531002841627,0.8174,7.8794,-5
"7279",1,20,24,4,-11.2806492815774,-9.1826,-9.1206,2
"7280",1,22,6,-16,-24.5431541792987,10.8174,8.8794,4
"7281",1,21,23,2,-13.3873047291601,-7.1826,-8.1206,3
"7282",1,16,20,4,-8.17769219162966,-9.1826,-5.1206,-2
"7283",1,17,8,-9,-16.9243399295798,3.8174,6.8794,-1
"7284",1,30,15,-15,-29.422069833589,9.8174,-0.1206,12
"7285",1,19,13,-6,-16.5342989807771,0.8174,1.8794,1
"7286",1,20,6,-14,-22.0121179372182,8.8174,8.8794,2
"7287",1,24,13,-11,-23.0860213974756,5.8174,1.8794,6
"7288",1,22,27,5,-12.0301166483278,-10.1826,-12.1206,4
"7289",1,25,3,-22,-30.1626473896281,16.8174,11.8794,7
"7290",1,9,29,20,6.10740733394882,-25.1826,-14.1206,-9
"7291",1,31,7,-24,-35.5442396518069,18.8174,7.8794,13
"7292",1,17,3,-14,-20.1534746814232,8.8174,11.8794,-1
"7293",1,19,12,-7,-16.9765986671764,1.8174,2.8794,1
"7294",1,19,16,-3,-14.4639503897009,-2.1826,-1.1206,1
"7295",1,17,22,5,-8.53477873523212,-10.1826,-7.1206,-1
"7296",1,18,10,-8,-16.8159927176892,2.8174,4.8794,0
"7297",1,16,15,-1,-11.3829763684356,-4.1826,-0.1206,-2
"7298",1,15,30,15,-1.1346244833111,-20.1826,-15.1206,-3
"7299",1,17,23,6,-7.77756902948541,-11.1826,-8.1206,-1
"7300",1,14,26,12,-2.0798323688806,-17.1826,-11.1206,-4
"7301",1,19,25,6,-9.32393808925432,-11.1826,-10.1206,1
"7302",1,25,24,-1,-17.6309147445478,-4.1826,-9.1206,7
"7303",1,20,27,7,-9.25278684358646,-12.1826,-12.1206,2
"7304",1,23,23,0,-15.5515353709761,-5.1826,-8.1206,5
"7305",1,23,21,-2,-16.6581807416947,-3.1826,-6.1206,5
"7306",1,15,29,14,-1.49975612452075,-19.1826,-14.1206,-3
"7307",1,22,17,-5,-17.858091439156,-0.1826,-2.1206,4
"7308",1,18,23,5,-9.15474000092566,-10.1826,-8.1206,0
"7309",1,21,30,9,-8.76305057111773,-14.1826,-15.1206,3
"7310",1,26,0,-26,-33.1029426780717,20.8174,14.8794,8
"7311",1,16,3,-13,-18.4696628895429,7.8174,11.8794,-2
"7312",1,18,13,-5,-15.2900785522909,-0.1826,1.8794,0
"7313",1,14,27,13,-1.67900685306432,-18.1826,-12.1206,-4
"7314",1,21,23,2,-12.9723353756005,-7.1826,-8.1206,3
"7315",1,17,25,8,-6.57646683530466,-13.1826,-10.1206,-1
"7316",1,16,30,14,-2.18649195271738,-19.1826,-15.1206,-2
"7317",1,29,13,-16,-29.2410485341257,10.8174,1.8794,11
"7318",1,24,3,-21,-28.8652285680199,15.8174,11.8794,6
"7319",1,25,5,-20,-29.0302833463241,14.8174,9.8794,7
"7320",1,14,22,8,-4.55262431041477,-13.1826,-7.1206,-4
"7321",1,26,27,1,-17.1385518777447,-6.1826,-12.1206,8
"7322",1,20,1,-19,-24.7349208995602,13.8174,13.8794,2
"7323",1,21,6,-15,-23.3906435280448,9.8174,8.8794,3
"7324",1,12,18,6,-4.02296633763749,-11.1826,-3.1206,-6
"7325",1,19,11,-8,-17.5293346099199,2.8174,3.8794,1
"7326",1,16,30,14,-1.91598653482596,-19.1826,-15.1206,-2
"7327",1,16,24,8,-6.11142001104842,-13.1826,-9.1206,-2
"7328",1,19,23,4,-10.3355655797783,-9.1826,-8.1206,1
"7329",1,21,5,-16,-23.8275100376694,10.8174,9.8794,3
"7330",1,13,24,11,-2.11949359175728,-16.1826,-9.1206,-5
"7331",1,17,26,9,-5.9347254014916,-14.1826,-11.1206,-1
"7332",1,27,8,-19,-29.8423230765044,13.8174,6.8794,9
"7333",1,18,6,-12,-19.0541671119969,6.8174,8.8794,0
"7334",1,21,6,-15,-23.2065859795126,9.8174,8.8794,3
"7335",1,22,9,-13,-22.6874766037026,7.8174,5.8794,4
"7336",1,18,28,10,-6.32552891329447,-15.1826,-13.1206,0
"7337",1,18,20,2,-10.8748777455894,-7.1826,-5.1206,0
"7338",1,17,9,-8,-16.1220019386856,2.8174,5.8794,-1
"7339",1,21,25,4,-11.9468856039605,-9.1826,-10.1206,3
"7340",1,18,15,-3,-13.9403963430192,-2.1826,-0.1206,0
"7341",1,22,21,-1,-15.546591481593,-4.1826,-6.1206,4
"7342",1,25,2,-23,-30.5161653323181,17.8174,12.8794,7
"7343",1,19,1,-18,-23.5030596029651,12.8174,13.8794,1
"7344",1,20,30,10,-7.26374970376304,-15.1826,-15.1206,2
"7345",1,17,4,-13,-19.0507248096846,7.8174,10.8794,-1
"7346",1,19,1,-18,-23.8366272035402,12.8174,13.8794,1
"7347",1,17,5,-12,-18.7918582565228,6.8174,9.8794,-1
"7348",1,23,26,3,-13.7772563824422,-8.1826,-11.1206,5
"7349",1,29,10,-19,-31.1002057061725,13.8174,4.8794,11
"7350",1,20,19,-1,-14.3511069877657,-4.1826,-4.1206,2
"7351",1,22,25,3,-12.5512319415096,-8.1826,-10.1206,4
"7352",1,15,17,2,-8.96311091852411,-7.1826,-2.1206,-3
"7353",1,36,6,-30,-42.7332648308773,24.8174,8.8794,18
"7354",1,20,30,10,-7.6040950008787,-15.1826,-15.1206,2
"7355",1,25,18,-7,-21.0075209914456,1.8174,-3.1206,7
"7356",1,28,17,-11,-25.7564625772587,5.8174,-2.1206,10
"7357",1,18,3,-15,-21.0627846413339,9.8174,11.8794,0
"7358",1,15,15,0,-10.126527012449,-5.1826,-0.1206,-3
"7359",1,14,1,-13,-17.2432788817056,7.8174,13.8794,-4
"7360",1,18,2,-16,-21.6225982744768,10.8174,12.8794,0
"7361",1,17,16,-1,-12.0130795154922,-4.1826,-1.1206,-1
"7362",1,15,17,2,-8.92820702750111,-7.1826,-2.1206,-3
"7363",1,21,21,0,-14.2006213562602,-5.1826,-6.1206,3
"7364",1,14,3,-11,-15.882696335818,5.8174,11.8794,-4
"7365",1,25,17,-8,-21.7227134150613,2.8174,-2.1206,7
"7366",1,22,12,-10,-20.8124410339152,4.8174,2.8794,4
"7367",1,19,19,0,-12.699864233264,-5.1826,-4.1206,1
"7368",1,17,17,0,-11.4845094399323,-5.1826,-2.1206,-1
"7369",1,17,20,3,-9.30372349639671,-8.1826,-5.1206,-1
"7370",1,28,29,1,-18.5492393448157,-6.1826,-14.1206,10
"7371",1,19,27,8,-7.85715138757566,-13.1826,-12.1206,1
"7372",1,20,4,-16,-23.3546086630313,10.8174,10.8794,2
"7373",1,22,11,-11,-21.590187406174,5.8174,3.8794,4
"7374",1,24,25,1,-15.8426802507619,-6.1826,-10.1206,6
"7375",1,29,0,-29,-37.2171024291195,23.8174,14.8794,11
"7376",1,28,30,2,-18.0042379137452,-7.1826,-15.1206,10
"7377",1,16,3,-13,-18.5332789031238,7.8174,11.8794,-2
"7378",1,22,14,-8,-19.4904163350513,2.8174,0.8794,4
"7379",1,26,28,2,-16.6497960689697,-7.1826,-13.1206,8
"7380",1,21,4,-17,-24.6090586704743,11.8174,10.8794,3
"7381",1,13,20,7,-4.46258334323586,-12.1826,-5.1206,-5
"7382",1,17,23,6,-7.67770536158607,-11.1826,-8.1206,-1
"7383",1,16,0,-16,-20.2293207406729,10.8174,14.8794,-2
"7384",1,20,24,4,-10.8719476192315,-9.1826,-9.1206,2
"7385",1,17,2,-15,-20.3589993742758,9.8174,12.8794,-1
"7386",1,18,6,-12,-19.3109447754283,6.8174,8.8794,0
"7387",1,16,9,-7,-14.863546522299,1.8174,5.8794,-2
"7388",1,27,7,-20,-30.451063587384,14.8174,7.8794,9
"7389",1,17,30,13,-3.62500124058167,-18.1826,-15.1206,-1
"7390",1,18,1,-17,-22.2552333681578,11.8174,13.8794,0
"7391",1,18,20,2,-10.9334615581821,-7.1826,-5.1206,0
"7392",1,28,19,-9,-24.4588252776263,3.8174,-4.1206,10
"7393",1,18,13,-5,-15.0478924433849,-0.1826,1.8794,0
"7394",1,17,28,11,-4.94637590394755,-16.1826,-13.1206,-1
"7395",1,14,21,7,-5.08260008364839,-12.1826,-6.1206,-4
"7396",1,19,2,-17,-22.8728465856743,11.8174,12.8794,1
"7397",1,14,15,1,-8.7206889172227,-6.1826,-0.1206,-4
"7398",1,18,0,-18,-22.956168286691,12.8174,14.8794,0
"7399",1,27,16,-11,-24.9072535023553,5.8174,-1.1206,9
"7400",1,18,2,-16,-21.5700031109336,10.8174,12.8794,0
"7401",1,19,11,-8,-17.9920532856347,2.8174,3.8794,1
"7402",1,22,9,-13,-22.6986235433641,7.8174,5.8794,4
"7403",1,27,7,-20,-30.3749764548518,14.8174,7.8794,9
"7404",1,28,20,-8,-24.1938647560327,2.8174,-5.1206,10
"7405",1,24,2,-22,-29.6744689068631,16.8174,12.8794,6
"7406",1,23,21,-2,-16.8425698586786,-3.1826,-6.1206,5
"7407",1,28,27,-1,-19.4726298081436,-4.1826,-12.1206,10
"7408",1,19,1,-18,-23.6567541730617,12.8174,13.8794,1
"7409",1,18,2,-16,-21.4154834199366,10.8174,12.8794,0
"7410",1,15,20,5,-6.6512461539164,-10.1826,-5.1206,-3
"7411",1,16,26,10,-4.74459244699464,-15.1826,-11.1206,-2
"7412",1,17,5,-12,-18.5072414199349,6.8174,9.8794,-1
"7413",1,21,13,-8,-18.9878894828415,2.8174,1.8794,3
"7414",1,16,6,-10,-16.7324881071931,4.8174,8.8794,-2
"7415",1,23,5,-18,-26.5767401312018,12.8174,9.8794,5
"7416",1,23,10,-13,-23.3507867473091,7.8174,4.8794,5
"7417",1,27,20,-7,-22.9140906955905,1.8174,-5.1206,9
"7418",1,25,6,-19,-28.2051588025949,13.8174,8.8794,7
"7419",1,19,11,-8,-17.7161475316957,2.8174,3.8794,1
"7420",1,12,30,18,2.93787388650184,-23.1826,-15.1206,-6
"7421",1,18,8,-10,-18.1437030412444,4.8174,6.8794,0
"7422",1,22,2,-20,-26.9391858464237,14.8174,12.8794,4
"7423",1,25,11,-14,-25.3965776900192,8.8174,3.8794,7
"7424",1,9,25,16,4.00259735887622,-21.1826,-10.1206,-9
"7425",1,12,4,-8,-12.848002889566,2.8174,10.8794,-6
"7426",1,24,30,6,-12.8791535031893,-11.1826,-15.1206,6
"7427",1,20,1,-19,-24.845979667954,13.8174,13.8794,2
"7428",1,12,4,-8,-12.777775285777,2.8174,10.8794,-6
"7429",1,24,22,-2,-17.4619785325788,-3.1826,-7.1206,6
"7430",1,19,7,-12,-20.1765313565195,6.8174,7.8794,1
"7431",1,21,13,-8,-19.1000424110166,2.8174,1.8794,3
"7432",1,14,26,12,-2.13263261410157,-17.1826,-11.1206,-4
"7433",1,20,21,1,-13.1572521101124,-6.1826,-6.1206,2
"7434",1,16,4,-12,-17.9875266396017,6.8174,10.8794,-2
"7435",1,17,1,-16,-21.1842497854861,10.8174,13.8794,-1
"7436",1,29,19,-10,-25.4339109266797,4.8174,-4.1206,11
"7437",1,14,24,10,-3.1133547150416,-15.1826,-9.1206,-4
"7438",1,18,18,0,-12.0422258391859,-5.1826,-3.1206,0
"7439",1,27,3,-24,-32.7511578269271,18.8174,11.8794,9
"7440",1,18,19,1,-11.5936848198153,-6.1826,-4.1206,0
"7441",1,24,0,-24,-30.9792403746624,18.8174,14.8794,6
"7442",1,24,9,-15,-25.1565901053901,9.8174,5.8794,6
"7443",1,18,11,-7,-16.4384528031209,1.8174,3.8794,0
"7444",1,25,13,-12,-24.3589061978662,6.8174,1.8794,7
"7445",1,23,20,-3,-17.2897806834805,-2.1826,-5.1206,5
"7446",1,25,21,-4,-19.1353637074139,-1.1826,-6.1206,7
"7447",1,20,1,-19,-24.8922725355989,13.8174,13.8794,2
"7448",1,20,11,-9,-18.7140125965049,3.8174,3.8794,2
"7449",1,16,4,-12,-17.6550945802604,6.8174,10.8794,-2
"7450",1,17,30,13,-3.60250359696321,-18.1826,-15.1206,-1
"7451",1,17,15,-2,-12.452832786983,-3.1826,-0.1206,-1
"7452",1,19,21,2,-11.6163789881832,-7.1826,-6.1206,1
"7453",1,17,19,2,-10.1511879907089,-7.1826,-4.1206,-1
"7454",1,19,19,0,-12.9512483093766,-5.1826,-4.1206,1
"7455",1,27,21,-6,-21.8964856787075,0.8174,-6.1206,9
"7456",1,21,13,-8,-18.8018086204751,2.8174,1.8794,3
"7457",1,24,11,-13,-23.8365755407552,7.8174,3.8794,6
"7458",1,18,17,-1,-12.5922928407482,-4.1826,-2.1206,0
"7459",1,23,2,-21,-28.3780562795187,15.8174,12.8794,5
"7460",1,23,6,-17,-25.7408774121909,11.8174,8.8794,5
"7461",1,17,27,10,-5.13303483217228,-15.1826,-12.1206,-1
"7462",1,19,17,-2,-13.700972161644,-3.1826,-2.1206,1
"7463",1,22,2,-20,-26.8440494772404,14.8174,12.8794,4
"7464",1,16,14,-2,-11.8597453558803,-3.1826,0.8794,-2
"7465",1,20,10,-10,-19.7150372981533,4.8174,4.8794,2
"7466",1,20,12,-8,-18.2586743081753,2.8174,2.8794,2
"7467",1,25,28,3,-15.1134513788547,-8.1826,-13.1206,7
"7468",1,14,0,-14,-17.8265162032569,8.8174,14.8794,-4
"7469",1,16,16,0,-10.7012016662511,-5.1826,-1.1206,-2
"7470",1,23,11,-12,-22.9039757276486,6.8174,3.8794,5
"7471",1,26,30,4,-15.4962795359319,-9.1826,-15.1206,8
"7472",1,23,13,-10,-21.7340867976813,4.8174,1.8794,5
"7473",1,19,8,-11,-19.4777963415308,5.8174,6.8794,1
"7474",1,17,3,-14,-19.7637579495035,8.8174,11.8794,-1
"7475",1,21,17,-4,-16.8324367210373,-1.1826,-2.1206,3
"7476",1,17,10,-7,-15.4500935455031,1.8174,4.8794,-1
"7477",1,15,29,14,-1.59612396159248,-19.1826,-14.1206,-3
"7478",1,20,26,6,-9.79384184892513,-11.1826,-11.1206,2
"7479",1,20,30,10,-7.4543137026297,-15.1826,-15.1206,2
"7480",1,19,4,-15,-21.7543442865655,9.8174,10.8794,1
"7481",1,21,19,-2,-15.4133024524099,-3.1826,-4.1206,3
"7482",1,14,30,16,0.0910651690268677,-21.1826,-15.1206,-4
"7483",1,12,28,16,1.80889905336035,-21.1826,-13.1206,-6
"7484",1,18,18,0,-11.9521990011546,-5.1826,-3.1206,0
"7485",1,20,10,-10,-19.5916061536363,4.8174,4.8794,2
"7486",1,21,20,-1,-14.6476617917796,-4.1826,-5.1206,3
"7487",1,20,28,8,-8.73090052046693,-13.1826,-13.1206,2
"7488",1,20,9,-11,-20.0851184615832,5.8174,5.8794,2
"7489",1,24,12,-12,-23.5032021947963,6.8174,2.8794,6
"7490",1,23,0,-23,-29.5202712321733,17.8174,14.8794,5
"7491",1,27,27,0,-18.508797603279,-5.1826,-12.1206,9
"7492",1,21,19,-2,-15.5337324514392,-3.1826,-4.1206,3
"7493",1,20,7,-13,-21.1461538460444,7.8174,7.8794,2
"7494",1,14,20,6,-5.46199484244641,-11.1826,-5.1206,-4
"7495",1,15,28,13,-2.32973525107669,-18.1826,-13.1206,-3
"7496",1,16,27,11,-4.09469823288526,-16.1826,-12.1206,-2
"7497",1,18,2,-16,-21.6208358409953,10.8174,12.8794,0
"7498",1,21,19,-2,-15.4325369784352,-3.1826,-4.1206,3
"7499",1,23,20,-3,-17.4992581582013,-2.1826,-5.1206,5
"7500",1,17,1,-16,-21.0913466087147,10.8174,13.8794,-1
"7501",1,29,17,-12,-26.6731947617598,6.8174,-2.1206,11
"7502",1,23,29,6,-12.2513682777738,-11.1826,-14.1206,5
"7503",1,18,14,-4,-14.352621359009,-1.1826,0.8794,0
"7504",1,24,14,-10,-22.210705915519,4.8174,0.8794,6
"7505",1,18,4,-14,-20.5039469568214,8.8174,10.8794,0
"7506",1,24,12,-12,-23.493400421645,6.8174,2.8794,6
"7507",1,13,3,-10,-14.4764236862765,4.8174,11.8794,-5
"7508",1,18,5,-13,-19.941280485939,7.8174,9.8794,0
"7509",1,26,23,-3,-19.601506099497,-2.1826,-8.1206,8
"7510",1,21,1,-20,-26.3012712782066,14.8174,13.8794,3
"7511",1,24,22,-2,-17.6894982310063,-3.1826,-7.1206,6
"7512",1,25,10,-15,-25.9453790490548,9.8174,4.8794,7
"7513",1,22,3,-19,-26.4916079596732,13.8174,11.8794,4
"7514",1,16,13,-3,-12.4915489789698,-2.1826,1.8794,-2
"7515",1,23,26,3,-13.5572140433024,-8.1826,-11.1206,5
"7516",1,21,9,-12,-21.5328225514465,6.8174,5.8794,3
"7517",1,24,18,-6,-19.790526899919,0.8174,-3.1206,6
"7518",1,16,10,-6,-14.3812048624186,0.8174,4.8794,-2
"7519",1,19,16,-3,-14.693868955753,-2.1826,-1.1206,1
"7520",1,26,26,0,-18.146023714322,-5.1826,-11.1206,8
"7521",1,24,29,5,-13.2199461323639,-10.1826,-14.1206,6
"7522",1,12,6,-6,-11.5700932096327,0.8174,8.8794,-6
"7523",1,19,30,11,-6.07974900269192,-16.1826,-15.1206,1
"7524",1,12,29,17,2.29007020811981,-22.1826,-14.1206,-6
"7525",1,21,22,1,-13.9169960923168,-6.1826,-7.1206,3
"7526",1,21,17,-4,-16.7740119806568,-1.1826,-2.1206,3
"7527",1,15,6,-9,-15.4264557579448,3.8174,8.8794,-3
"7528",1,22,20,-2,-16.1197125579383,-3.1826,-5.1206,4
"7529",1,26,6,-20,-29.8820054850854,14.8174,8.8794,8
"7530",1,19,7,-12,-19.9083081064686,6.8174,7.8794,1
"7531",1,17,8,-9,-16.8891419076502,3.8174,6.8794,-1
"7532",1,21,28,7,-10.1157366554441,-12.1826,-13.1206,3
"7533",1,19,25,6,-9.18168879193182,-11.1826,-10.1206,1
"7534",1,19,25,6,-9.41640636382414,-11.1826,-10.1206,1
"7535",1,17,5,-12,-18.4618549107211,6.8174,9.8794,-1
"7536",1,19,26,7,-8.78783594715839,-12.1826,-11.1206,1
"7537",1,24,27,3,-14.5248558477456,-8.1826,-12.1206,6
"7538",1,27,27,0,-18.4006343349379,-5.1826,-12.1206,9
"7539",1,22,12,-10,-20.9735760720951,4.8174,2.8794,4
"7540",1,23,15,-8,-20.1995954464832,2.8174,-0.1206,5
"7541",1,16,29,13,-2.79737527524506,-18.1826,-14.1206,-2
"7542",1,23,30,7,-11.481733809776,-12.1826,-15.1206,5
"7543",1,22,14,-8,-19.6657265193913,2.8174,0.8794,4
"7544",1,21,17,-4,-16.5743671096224,-1.1826,-2.1206,3
"7545",1,14,24,10,-3.31284241899591,-15.1826,-9.1206,-4
"7546",1,19,28,9,-7.34603451931221,-14.1826,-13.1206,1
"7547",1,26,22,-4,-20.2017025327163,-1.1826,-7.1206,8
"7548",1,22,6,-16,-24.3268122268065,10.8174,8.8794,4
"7549",1,11,1,-10,-13.346408732259,4.8174,13.8794,-7
"7550",1,17,20,3,-9.35377939413697,-8.1826,-5.1206,-1
"7551",1,17,22,5,-8.1750145527868,-10.1826,-7.1206,-1
"7552",1,18,21,3,-10.3720714283797,-8.1826,-6.1206,0
"7553",1,20,11,-9,-19.100248641447,3.8174,3.8794,2
"7554",1,27,26,-1,-18.973053783259,-4.1826,-11.1206,9
"7555",1,18,1,-17,-22.4092615056907,11.8174,13.8794,0
"7556",1,18,10,-8,-16.8991257772149,2.8174,4.8794,0
"7557",1,19,10,-9,-18.2736822253703,3.8174,4.8794,1
"7558",1,24,8,-16,-25.837368851958,10.8174,6.8794,6
"7559",1,17,14,-3,-13.1801859329416,-2.1826,0.8794,-1
"7560",1,16,10,-6,-14.2773154616303,0.8174,4.8794,-2
"7561",1,10,5,-5,-9.46470867407041,-0.1826,9.8794,-8
"7562",1,28,4,-24,-33.7234838391233,18.8174,10.8794,10
"7563",1,18,17,-1,-13.1405261300694,-4.1826,-2.1206,0
"7564",1,17,15,-2,-12.3420357682612,-3.1826,-0.1206,-1
"7565",1,21,12,-9,-19.4797149142214,3.8174,2.8794,3
"7566",1,18,12,-6,-15.8296120710642,0.8174,2.8794,0
"7567",1,26,27,1,-17.1375210202093,-6.1826,-12.1206,8
"7568",1,21,20,-1,-14.9605572865744,-4.1826,-5.1206,3
"7569",1,19,23,4,-10.5863397531913,-9.1826,-8.1206,1
"7570",1,22,15,-7,-19.1443476518578,1.8174,-0.1206,4
"7571",1,19,2,-17,-23.0993283241571,11.8174,12.8794,1
"7572",1,26,13,-13,-25.6984153060029,7.8174,1.8794,8
"7573",1,13,26,13,-1.00892506892893,-18.1826,-11.1206,-5
"7574",1,26,22,-4,-19.999049960017,-1.1826,-7.1206,8
"7575",1,22,29,7,-10.7579115598977,-12.1826,-14.1206,4
"7576",1,17,25,8,-6.53410660510535,-13.1826,-10.1206,-1
"7577",1,20,5,-15,-22.4112275621382,9.8174,9.8794,2
"7578",1,19,28,9,-7.38944366059864,-14.1826,-13.1206,1
"7579",1,22,27,5,-12.0996371840563,-10.1826,-12.1206,4
"7580",1,15,19,4,-7.65442491045708,-9.1826,-4.1206,-3
"7581",1,17,9,-8,-16.1256824579595,2.8174,5.8794,-1
"7582",1,14,14,0,-9.26696174640802,-5.1826,0.8794,-4
"7583",1,18,12,-6,-15.890615535352,0.8174,2.8794,0
"7584",1,19,17,-2,-14.066106466874,-3.1826,-2.1206,1
"7585",1,18,4,-14,-20.8504133521573,8.8174,10.8794,0
"7586",1,21,28,7,-9.92678303441215,-12.1826,-13.1206,3
"7587",1,17,11,-6,-14.7562750285696,0.8174,3.8794,-1
"7588",1,19,5,-14,-21.1311727388016,8.8174,9.8794,1
"7589",1,16,23,7,-6.73012133074321,-12.1826,-8.1206,-2
"7590",1,21,0,-21,-26.7415652679904,15.8174,14.8794,3
"7591",1,21,15,-6,-17.7936326276767,0.8174,-0.1206,3
"7592",1,17,16,-1,-11.8540715974496,-4.1826,-1.1206,-1
"7593",1,20,30,10,-7.46930577467652,-15.1826,-15.1206,2
"7594",1,22,11,-11,-21.3543626804916,5.8174,3.8794,4
"7595",1,19,27,8,-7.94219648306455,-13.1826,-12.1206,1
"7596",1,22,2,-20,-26.5222882255563,14.8174,12.8794,4
"7597",1,24,23,-1,-16.836598578536,-4.1826,-8.1206,6
"7598",1,21,17,-4,-16.5810188666372,-1.1826,-2.1206,3
"7599",1,16,26,10,-4.54395484799056,-15.1826,-11.1206,-2
"7600",1,20,19,-1,-13.8419287179188,-4.1826,-4.1206,2
"7601",1,18,10,-8,-16.8873072588862,2.8174,4.8794,0
"7602",1,16,5,-11,-17.2987635859875,5.8174,9.8794,-2
"7603",1,23,27,4,-13.3365956414894,-9.1826,-12.1206,5
"7604",1,18,4,-14,-20.3560763845363,8.8174,10.8794,0
"7605",1,24,6,-18,-26.7370518690793,12.8174,8.8794,6
"7606",1,24,4,-20,-28.1614677808827,14.8174,10.8794,6
"7607",1,15,0,-15,-19.2741974394954,9.8174,14.8794,-3
"7608",1,21,19,-2,-15.4793082068605,-3.1826,-4.1206,3
"7609",1,25,27,2,-16.1192916450626,-7.1826,-12.1206,7
"7610",1,21,25,4,-11.6223459301484,-9.1826,-10.1206,3
"7611",1,19,5,-14,-21.2322852382454,8.8174,9.8794,1
"7612",1,22,27,5,-11.6981113935389,-10.1826,-12.1206,4
"7613",1,16,12,-4,-12.9436750814458,-1.1826,2.8794,-2
"7614",1,19,18,-1,-13.4655525301708,-4.1826,-3.1206,1
"7615",1,27,23,-4,-20.6729732934929,-1.1826,-8.1206,9
"7616",1,28,21,-7,-23.4990617328293,1.8174,-6.1206,10
"7617",1,22,6,-16,-24.6085040276552,10.8174,8.8794,4
"7618",1,17,29,12,-4.38271357851577,-17.1826,-14.1206,-1
"7619",1,21,12,-9,-19.469402863074,3.8174,2.8794,3
"7620",1,13,25,12,-1.4095049936948,-17.1826,-10.1206,-5
"7621",1,23,8,-15,-24.6295314001651,9.8174,6.8794,5
"7622",1,24,29,5,-13.4952695183477,-10.1826,-14.1206,6
"7623",1,19,29,10,-6.71780069836833,-15.1826,-14.1206,1
"7624",1,19,10,-9,-17.9930775185192,3.8174,4.8794,1
"7625",1,30,1,-29,-37.9766294842626,23.8174,13.8794,12
"7626",1,19,25,6,-9.26581242816839,-11.1826,-10.1206,1
"7627",1,13,1,-12,-16.0331474842594,6.8174,13.8794,-5
"7628",1,23,30,7,-11.5064029944976,-12.1826,-15.1206,5
"7629",1,25,27,2,-15.7710005924687,-7.1826,-12.1206,7
"7630",1,19,24,5,-9.81997249978951,-10.1826,-9.1206,1
"7631",1,13,22,9,-3.46932496943169,-14.1826,-7.1206,-5
"7632",1,21,5,-16,-24.0360786052696,10.8174,9.8794,3
"7633",1,15,18,3,-8.35924390984259,-8.1826,-3.1206,-3
"7634",1,22,3,-19,-26.1769046600509,13.8174,11.8794,4
"7635",1,22,6,-16,-24.4668591750217,10.8174,8.8794,4
"7636",1,16,25,9,-5.43471810984894,-14.1826,-10.1206,-2
"7637",1,13,20,7,-4.64033776426126,-12.1826,-5.1206,-5
"7638",1,11,1,-10,-13.1618691081314,4.8174,13.8794,-7
"7639",1,22,10,-12,-21.9913249765112,6.8174,4.8794,4
"7640",1,23,27,4,-12.9400446930557,-9.1826,-12.1206,5
"7641",1,18,18,0,-12.0434294065407,-5.1826,-3.1206,0
"7642",1,21,24,3,-12.4924546640629,-8.1826,-9.1206,3
"7643",1,21,8,-13,-21.9450783042313,7.8174,6.8794,3
"7644",1,22,19,-3,-16.8847780603054,-2.1826,-4.1206,4
"7645",1,23,13,-10,-21.6362581779736,4.8174,1.8794,5
"7646",1,17,10,-7,-15.8151098198972,1.8174,4.8794,-1
"7647",1,21,21,0,-14.1729346136793,-5.1826,-6.1206,3
"7648",1,21,8,-13,-22.0873608574147,7.8174,6.8794,3
"7649",1,16,23,7,-6.37184665918999,-12.1826,-8.1206,-2
"7650",1,23,19,-4,-18.117119964289,-1.1826,-4.1206,5
"7651",1,14,11,-3,-11.0899233236587,-2.1826,3.8794,-4
"7652",1,25,6,-19,-28.2263773905522,13.8174,8.8794,7
"7653",1,12,6,-6,-11.6873739937701,0.8174,8.8794,-6
"7654",1,26,4,-22,-30.9209722589685,16.8174,10.8794,8
"7655",1,21,5,-16,-23.5210621229595,10.8174,9.8794,3
"7656",1,20,3,-17,-23.6690185002539,11.8174,11.8794,2
"7657",1,19,8,-11,-19.5736727984823,5.8174,6.8794,1
"7658",1,25,20,-5,-20.2280440877241,-0.1826,-5.1206,7
"7659",1,24,19,-5,-18.9742738461239,-0.1826,-4.1206,6
"7660",1,18,21,3,-10.2413085545593,-8.1826,-6.1206,0
"7661",1,19,24,5,-9.89611038632698,-10.1826,-9.1206,1
"7662",1,26,13,-13,-25.2996958965492,7.8174,1.8794,8
"7663",1,21,22,1,-13.5002982794038,-6.1826,-7.1206,3
"7664",1,25,8,-17,-27.0702185157942,11.8174,6.8794,7
"7665",1,28,12,-16,-28.3563056551759,10.8174,2.8794,10
"7666",1,15,9,-6,-13.615431793975,0.8174,5.8794,-3
"7667",1,22,22,0,-14.6655503570595,-5.1826,-7.1206,4
"7668",1,25,18,-7,-21.2627919306836,1.8174,-3.1206,7
"7669",1,18,7,-11,-19.1585061990074,5.8174,7.8794,0
"7670",1,13,16,3,-6.91757599695755,-8.1826,-1.1206,-5
"7671",1,24,8,-16,-26.0661069431867,10.8174,6.8794,6
"7672",1,22,19,-3,-16.5388996841024,-2.1826,-4.1206,4
"7673",1,33,7,-26,-38.2058465588046,20.8174,7.8794,15
"7674",1,26,12,-14,-25.9514271931668,8.8174,2.8794,8
"7675",1,15,18,3,-7.86395451224859,-8.1826,-3.1206,-3
"7676",1,20,0,-20,-25.3844679579016,14.8174,14.8794,2
"7677",1,16,19,3,-8.94379829891679,-8.1826,-4.1206,-2
"7678",1,19,12,-7,-16.7096167317716,1.8174,2.8794,1
"7679",1,18,7,-11,-18.6325432547041,5.8174,7.8794,0
"7680",1,20,22,2,-12.3307700737339,-7.1826,-7.1206,2
"7681",1,24,8,-16,-25.9133162340505,10.8174,6.8794,6
"7682",1,21,3,-18,-24.9729918587108,12.8174,11.8794,3
"7683",1,16,8,-8,-15.3958035196602,2.8174,6.8794,-2
"7684",1,20,28,8,-8.33068595999631,-13.1826,-13.1206,2
"7685",1,18,3,-15,-21.0119573032079,9.8174,11.8794,0
"7686",1,13,19,6,-4.98501896836631,-11.1826,-4.1206,-5
"7687",1,23,11,-12,-22.8282021322285,6.8174,3.8794,5
"7688",1,21,21,0,-14.3112959661936,-5.1826,-6.1206,3
"7689",1,24,29,5,-13.159385715439,-10.1826,-14.1206,6
"7690",1,14,15,1,-8.67553521647162,-6.1826,-0.1206,-4
"7691",1,23,10,-13,-23.5662856001012,7.8174,4.8794,5
"7692",1,8,26,18,6.12232906896876,-23.1826,-11.1206,-10
"7693",1,17,4,-13,-19.2070614771578,7.8174,10.8794,-1
"7694",1,20,21,1,-12.6901067836403,-6.1826,-6.1206,2
"7695",1,16,3,-13,-18.4656063310028,7.8174,11.8794,-2
"7696",1,18,21,3,-10.262586031176,-8.1826,-6.1206,0
"7697",1,16,28,12,-3.40097703407637,-17.1826,-13.1206,-2
"7698",1,22,9,-13,-22.3139366198889,7.8174,5.8794,4
"7699",1,17,20,3,-9.78660235658375,-8.1826,-5.1206,-1
"7700",1,19,9,-10,-18.6613629509018,4.8174,5.8794,1
"7701",1,27,18,-9,-23.6417493384316,3.8174,-3.1206,9
"7702",1,23,1,-22,-28.7219226269217,16.8174,13.8794,5
"7703",1,18,19,1,-11.6585551878125,-6.1826,-4.1206,0
"7704",1,14,1,-13,-17.025995168474,7.8174,13.8794,-4
"7705",1,23,3,-20,-27.7952095755448,14.8174,11.8794,5
"7706",1,32,4,-28,-38.5488080176063,22.8174,10.8794,14
"7707",1,22,26,4,-12.5044217106789,-9.1826,-11.1206,4
"7708",1,32,18,-14,-30.5635051006557,8.8174,-3.1206,14
"7709",1,15,0,-15,-18.9165779147042,9.8174,14.8794,-3
"7710",1,27,16,-11,-24.8645357542173,5.8174,-1.1206,9
"7711",1,26,29,3,-16.01689064362,-8.1826,-14.1206,8
"7712",1,18,22,4,-9.72593788589628,-9.1826,-7.1206,0
"7713",1,22,22,0,-14.9861637267224,-5.1826,-7.1206,4
"7714",1,20,28,8,-8.48148092520632,-13.1826,-13.1206,2
"7715",1,21,20,-1,-14.8667296040051,-4.1826,-5.1206,3
"7716",1,18,26,8,-7.37056354031014,-13.1826,-11.1206,0
"7717",1,26,1,-25,-32.6119931753908,19.8174,13.8794,8
"7718",1,15,16,1,-9.31599604833756,-6.1826,-1.1206,-3
"7719",1,29,13,-16,-29.2225207696668,10.8174,1.8794,11
"7720",1,18,5,-13,-19.8823139823255,7.8174,9.8794,0
"7721",1,19,4,-15,-21.7573969579002,9.8174,10.8794,1
"7722",1,20,3,-17,-23.8122181429358,11.8174,11.8794,2
"7723",1,22,6,-16,-24.6393753458577,10.8174,8.8794,4
"7724",1,33,0,-33,-42.4327492230923,27.8174,14.8794,15
"7725",1,15,21,6,-6.58735048391727,-11.1826,-6.1206,-3
"7726",1,15,10,-5,-13.085603979796,-0.1826,4.8794,-3
"7727",1,27,0,-27,-34.4109276349208,21.8174,14.8794,9
"7728",1,24,29,5,-13.6746619676036,-10.1826,-14.1206,6
"7729",1,21,19,-2,-15.5281286116131,-3.1826,-4.1206,3
"7730",1,18,17,-1,-12.6526436934627,-4.1826,-2.1206,0
"7731",1,25,14,-11,-23.6749423064836,5.8174,0.8794,7
"7732",1,19,0,-19,-24.3514715771761,13.8174,14.8794,1
"7733",1,17,22,5,-8.59805381922484,-10.1826,-7.1206,-1
"7734",1,12,5,-7,-12.2225304659559,1.8174,9.8794,-6
"7735",1,19,3,-16,-22.735463801678,10.8174,11.8794,1
"7736",1,22,21,-1,-15.4423601750446,-4.1826,-6.1206,4
"7737",1,16,3,-13,-18.6790784778893,7.8174,11.8794,-2
"7738",1,22,28,6,-11.3180077551722,-11.1826,-13.1206,4
"7739",1,27,13,-14,-26.8767865905914,8.8174,1.8794,9
"7740",1,26,8,-18,-28.6145038473134,12.8174,6.8794,8
"7741",1,25,11,-14,-25.671109045474,8.8174,3.8794,7
"7742",1,22,26,4,-12.4980298074128,-9.1826,-11.1206,4
"7743",1,20,18,-2,-14.5491448045593,-3.1826,-3.1206,2
"7744",1,15,4,-11,-16.3808893898177,5.8174,10.8794,-3
"7745",1,21,23,2,-12.998636346814,-7.1826,-8.1206,3
"7746",1,29,24,-5,-22.7801994530971,-0.1826,-9.1206,11
"7747",1,31,17,-14,-30.031900839015,8.8174,-2.1206,13
"7748",1,24,13,-11,-22.8952035592817,5.8174,1.8794,6
"7749",1,30,7,-23,-34.4259524304815,17.8174,7.8794,12
"7750",1,14,28,14,-0.928726873821532,-19.1826,-13.1206,-4
"7751",1,17,26,9,-5.78279331924734,-14.1826,-11.1206,-1
"7752",1,24,26,2,-15.1651287190854,-7.1826,-11.1206,6
"7753",1,22,0,-22,-28.234262840098,16.8174,14.8794,4
"7754",1,20,19,-1,-13.9523695762128,-4.1826,-4.1206,2
"7755",1,17,21,4,-9.06707772799112,-9.1826,-6.1206,-1
"7756",1,22,20,-2,-16.1321591267513,-3.1826,-5.1206,4
"7757",1,20,22,2,-12.2764839129299,-7.1826,-7.1206,2
"7758",1,17,11,-6,-14.9883116675242,0.8174,3.8794,-1
"7759",1,11,10,-1,-7.57596608020929,-4.1826,4.8794,-7
"7760",1,12,11,-1,-8.41764888221602,-4.1826,3.8794,-6
"7761",1,14,6,-8,-14.2238281410944,2.8174,8.8794,-4
"7762",1,17,1,-16,-20.9480772404854,10.8174,13.8794,-1
"7763",1,25,26,1,-16.3690865893181,-6.1826,-11.1206,7
"7764",1,13,14,1,-8.13668851783043,-6.1826,0.8794,-5
"7765",1,20,5,-15,-22.6377982594842,9.8174,9.8794,2
"7766",1,25,0,-25,-31.5337952427316,19.8174,14.8794,7
"7767",1,18,9,-9,-17.758585128504,3.8174,5.8794,0
"7768",1,23,0,-23,-29.2860310904029,17.8174,14.8794,5
"7769",1,20,12,-8,-18.3431347120338,2.8174,2.8794,2
"7770",1,15,19,4,-7.76084057355211,-9.1826,-4.1206,-3
"7771",1,26,4,-22,-30.8022904804368,16.8174,10.8794,8
"7772",1,20,10,-10,-19.6859124219222,4.8174,4.8794,2
"7773",1,19,11,-8,-17.4991587721878,2.8174,3.8794,1
"7774",1,24,25,1,-15.7930504412667,-6.1826,-10.1206,6
"7775",1,22,15,-7,-19.0369428499313,1.8174,-0.1206,4
"7776",1,15,12,-3,-11.9307011611895,-2.1826,2.8794,-3
"7777",1,15,24,9,-4.43759174956906,-14.1826,-9.1206,-3
"7778",1,13,26,13,-0.728626584444038,-18.1826,-11.1206,-5
"7779",1,21,27,6,-10.6325060066443,-11.1826,-12.1206,3
"7780",1,18,23,5,-8.75547125300462,-10.1826,-8.1206,0
"7781",1,21,0,-21,-26.8695318802188,15.8174,14.8794,3
"7782",1,22,2,-20,-26.815031326989,14.8174,12.8794,4
"7783",1,21,21,0,-14.0519526325894,-5.1826,-6.1206,3
"7784",1,20,22,2,-12.3069379106668,-7.1826,-7.1206,2
"7785",1,24,17,-7,-20.3329242643755,1.8174,-2.1206,6
"7786",1,10,27,17,3.77295697307378,-22.1826,-12.1206,-8
"7787",1,15,16,1,-9.77755659910047,-6.1826,-1.1206,-3
"7788",1,28,25,-3,-20.8389666234348,-2.1826,-10.1206,10
"7789",1,17,5,-12,-18.6167530915286,6.8174,9.8794,-1
"7790",1,24,20,-4,-18.859193643743,-1.1826,-5.1206,6
"7791",1,23,26,3,-14.0885404253987,-8.1826,-11.1206,5
"7792",1,24,11,-13,-23.958747696016,7.8174,3.8794,6
"7793",1,22,16,-6,-18.2612828338258,0.8174,-1.1206,4
"7794",1,17,3,-14,-19.8570677243628,8.8174,11.8794,-1
"7795",1,22,13,-9,-20.051966228603,3.8174,1.8794,4
"7796",1,20,12,-8,-18.2983508575762,2.8174,2.8794,2
"7797",1,24,22,-2,-17.309138268117,-3.1826,-7.1206,6
"7798",1,13,25,12,-1.16890860126742,-17.1826,-10.1206,-5
"7799",1,22,28,6,-11.4470892816313,-11.1826,-13.1206,4
"7800",1,13,19,6,-4.96431625346274,-11.1826,-4.1206,-5
"7801",1,29,26,-3,-21.8169790009763,-2.1826,-11.1206,11
"7802",1,14,12,-2,-10.7650268790643,-3.1826,2.8794,-4
"7803",1,21,24,3,-12.4548613465879,-8.1826,-9.1206,3
"7804",1,25,28,3,-15.3599967935676,-8.1826,-13.1206,7
"7805",1,19,25,6,-9.17798079629805,-11.1826,-10.1206,1
"7806",1,18,3,-15,-21.0809351600751,9.8174,11.8794,0
"7807",1,17,21,4,-8.79321141001921,-9.1826,-6.1206,-1
"7808",1,21,10,-11,-20.6685766330577,5.8174,4.8794,3
"7809",1,17,15,-2,-12.5755467738287,-3.1826,-0.1206,-1
"7810",1,27,16,-11,-25.105974088829,5.8174,-1.1206,9
"7811",1,15,15,0,-9.79426321416972,-5.1826,-0.1206,-3
"7812",1,26,20,-6,-21.3016750863579,0.8174,-5.1206,8
"7813",1,17,3,-14,-19.7136692117355,8.8174,11.8794,-1
"7814",1,20,30,10,-7.48847727531872,-15.1826,-15.1206,2
"7815",1,22,16,-6,-18.7097216708385,0.8174,-1.1206,4
"7816",1,28,10,-18,-29.9058102731841,12.8174,4.8794,10
"7817",1,17,18,1,-10.9519213075425,-6.1826,-3.1206,-1
"7818",1,17,2,-15,-20.1728949114146,9.8174,12.8794,-1
"7819",1,25,15,-10,-23.1348792349271,4.8174,-0.1206,7
"7820",1,28,27,-1,-19.3977480208765,-4.1826,-12.1206,10
"7821",1,17,21,4,-9.09475819028565,-9.1826,-6.1206,-1
"7822",1,22,11,-11,-21.5648447293119,5.8174,3.8794,4
"7823",1,20,30,10,-7.71862635397449,-15.1826,-15.1206,2
"7824",1,16,4,-12,-18.1187961089346,6.8174,10.8794,-2
"7825",1,28,16,-12,-26.5919894320589,6.8174,-1.1206,10
"7826",1,15,12,-3,-11.6801022056421,-2.1826,2.8794,-3
"7827",1,13,2,-11,-15.189127460692,5.8174,12.8794,-5
"7828",1,15,12,-3,-11.9112549562894,-2.1826,2.8794,-3
"7829",1,17,16,-1,-12.0905625087786,-4.1826,-1.1206,-1
"7830",1,15,9,-6,-13.5039070292753,0.8174,5.8794,-3
"7831",1,26,16,-10,-23.8255765270675,4.8174,-1.1206,8
"7832",1,18,11,-7,-16.4711812398809,1.8174,3.8794,0
"7833",1,24,14,-10,-22.1680464405595,4.8174,0.8794,6
"7834",1,20,23,3,-11.4486780292338,-8.1826,-8.1206,2
"7835",1,17,21,4,-9.22415394736445,-9.1826,-6.1206,-1
"7836",1,22,17,-5,-17.9081326340442,-0.1826,-2.1206,4
"7837",1,31,11,-20,-33.081637835188,14.8174,3.8794,13
"7838",1,15,7,-8,-14.7786919911563,2.8174,7.8794,-3
"7839",1,17,22,5,-8.32785822697876,-10.1826,-7.1206,-1
"7840",1,16,12,-4,-13.1361663965403,-1.1826,2.8794,-2
"7841",1,13,20,7,-4.2816241729234,-12.1826,-5.1206,-5
"7842",1,15,25,10,-4.20474290039892,-15.1826,-10.1206,-3
"7843",1,26,7,-19,-29.0625054308769,13.8174,7.8794,8
"7844",1,17,27,10,-5.51715708941381,-15.1826,-12.1206,-1
"7845",1,27,0,-27,-34.646999669078,21.8174,14.8794,9
"7846",1,26,22,-4,-19.9279291123956,-1.1826,-7.1206,8
"7847",1,20,12,-8,-18.3402096795374,2.8174,2.8794,2
"7848",1,22,14,-8,-19.536486490373,2.8174,0.8794,4
"7849",1,19,25,6,-9.25884896444367,-11.1826,-10.1206,1
"7850",1,11,12,1,-6.47875616751534,-6.1826,2.8794,-7
"7851",1,23,12,-11,-22.040008028274,5.8174,2.8794,5
"7852",1,15,24,9,-4.3410624106879,-14.1826,-9.1206,-3
"7853",1,24,29,5,-13.1907298003583,-10.1826,-14.1206,6
"7854",1,16,3,-13,-18.3780558017778,7.8174,11.8794,-2
"7855",1,17,27,10,-5.18862846021736,-15.1826,-12.1206,-1
"7856",1,29,2,-27,-35.8807626826403,21.8174,12.8794,11
"7857",1,17,7,-10,-17.3078398819234,4.8174,7.8794,-1
"7858",1,24,26,2,-15.1006596585423,-7.1826,-11.1206,6
"7859",1,19,20,1,-12.1220412201581,-6.1826,-5.1206,1
"7860",1,15,2,-13,-17.7975505217397,7.8174,12.8794,-3
"7861",1,24,30,6,-12.7880899545707,-11.1826,-15.1206,6
"7862",1,17,17,0,-11.4840017927648,-5.1826,-2.1206,-1
"7863",1,26,5,-21,-30.3660421572792,15.8174,9.8794,8
"7864",1,16,6,-10,-16.8874339674096,4.8174,8.8794,-2
"7865",1,18,15,-3,-14.1344476275106,-2.1826,-0.1206,0
"7866",1,23,18,-5,-18.6184832608791,-0.1826,-3.1206,5
"7867",1,16,25,9,-5.33957400241014,-14.1826,-10.1206,-2
"7868",1,20,28,8,-8.36529561107083,-13.1826,-13.1206,2
"7869",1,16,10,-6,-14.0388135200922,0.8174,4.8794,-2
"7870",1,19,14,-5,-15.7168981025809,-0.1826,0.8794,1
"7871",1,21,5,-16,-23.6173532623649,10.8174,9.8794,3
"7872",1,19,12,-7,-16.9414020657103,1.8174,2.8794,1
"7873",1,15,27,12,-2.77014061561542,-17.1826,-12.1206,-3
"7874",1,26,6,-20,-29.8645607058767,14.8174,8.8794,8
"7875",1,21,20,-1,-14.8099840090799,-4.1826,-5.1206,3
"7876",1,24,1,-23,-30.2279794974307,17.8174,13.8794,6
"7877",1,15,20,5,-7.04787139817229,-10.1826,-5.1206,-3
"7878",1,16,14,-2,-11.590530403382,-3.1826,0.8794,-2
"7879",1,25,25,0,-17.2683572754267,-5.1826,-10.1206,7
"7880",1,18,29,11,-5.49348730904746,-16.1826,-14.1206,0
"7881",1,14,23,9,-4.12954710615474,-14.1826,-8.1206,-4
"7882",1,17,26,9,-5.93663649562217,-14.1826,-11.1206,-1
"7883",1,14,21,7,-5.15152949409801,-12.1826,-6.1206,-4
"7884",1,15,17,2,-8.74691176127828,-7.1826,-2.1206,-3
"7885",1,20,14,-6,-17.0159990285675,0.8174,0.8794,2
"7886",1,20,23,3,-11.741548611685,-8.1826,-8.1206,2
"7887",1,19,0,-19,-24.2666935580098,13.8174,14.8794,1
"7888",1,10,23,13,1.58656438427476,-18.1826,-8.1206,-8
"7889",1,18,30,12,-5.09146470237187,-17.1826,-15.1206,0
"7890",1,17,13,-4,-13.5585193485343,-1.1826,1.8794,-1
"7891",1,21,9,-12,-21.499320866469,6.8174,5.8794,3
"7892",1,29,17,-12,-26.9860930713948,6.8174,-2.1206,11
"7893",1,19,9,-10,-18.8385110056381,4.8174,5.8794,1
"7894",1,28,19,-9,-24.5752425999181,3.8174,-4.1206,10
"7895",1,23,1,-22,-28.732793001702,16.8174,13.8794,5
"7896",1,26,29,3,-15.7421956875695,-8.1826,-14.1206,8
"7897",1,19,17,-2,-14.1010612086359,-3.1826,-2.1206,1
"7898",1,22,25,3,-13.1016021226047,-8.1826,-10.1206,4
"7899",1,17,9,-8,-16.0772799312255,2.8174,5.8794,-1
"7900",1,27,18,-9,-23.6236390739039,3.8174,-3.1206,9
"7901",1,21,21,0,-14.212107699008,-5.1826,-6.1206,3
"7902",1,19,7,-12,-20.105736040682,6.8174,7.8794,1
"7903",1,19,4,-15,-21.6850734490601,9.8174,10.8794,1
"7904",1,24,12,-12,-23.7092346527127,6.8174,2.8794,6
"7905",1,27,24,-3,-20.3423879064286,-2.1826,-9.1206,9
"7906",1,23,16,-7,-19.8320943466232,1.8174,-1.1206,5
"7907",1,15,0,-15,-19.0296942221137,9.8174,14.8794,-3
"7908",1,29,11,-18,-30.6983851623386,12.8174,3.8794,11
"7909",1,23,19,-4,-18.0319232703587,-1.1826,-4.1206,5
"7910",1,12,23,11,-1.17337739959567,-16.1826,-8.1206,-6
"7911",1,24,9,-15,-25.4272994996225,9.8174,5.8794,6
"7912",1,18,17,-1,-12.9297750810807,-4.1826,-2.1206,0
"7913",1,22,24,2,-13.765245502679,-7.1826,-9.1206,4
"7914",1,22,24,2,-13.6125431945852,-7.1826,-9.1206,4
"7915",1,18,14,-4,-14.4378640978034,-1.1826,0.8794,0
"7916",1,18,6,-12,-19.4525897510114,6.8174,8.8794,0
"7917",1,18,20,2,-11.2513426304442,-7.1826,-5.1206,0
"7918",1,19,9,-10,-18.8709321090125,4.8174,5.8794,1
"7919",1,25,24,-1,-17.8388532173703,-4.1826,-9.1206,7
"7920",1,21,2,-19,-25.4135305304927,13.8174,12.8794,3
"7921",1,24,23,-1,-17.0085060138772,-4.1826,-8.1206,6
"7922",1,15,18,3,-8.2559476689567,-8.1826,-3.1206,-3
"7923",1,20,6,-14,-21.7394938009472,8.8174,8.8794,2
"7924",1,25,29,4,-14.6709129009944,-9.1826,-14.1206,7
"7925",1,14,15,1,-8.58404334832544,-6.1826,-0.1206,-4
"7926",1,11,4,-7,-11.293122760039,1.8174,10.8794,-7
"7927",1,18,9,-9,-17.4987629637603,3.8174,5.8794,0
"7928",1,20,7,-13,-21.3889429693078,7.8174,7.8794,2
"7929",1,20,18,-2,-14.4747742739936,-3.1826,-3.1206,2
"7930",1,20,21,1,-12.9841473760599,-6.1826,-6.1206,2
"7931",1,23,0,-23,-29.3726195604697,17.8174,14.8794,5
"7932",1,24,10,-14,-24.7513612496093,8.8174,4.8794,6
"7933",1,22,27,5,-12.0724645434122,-10.1826,-12.1206,4
"7934",1,26,3,-23,-31.4150116592796,17.8174,11.8794,8
"7935",1,23,12,-11,-22.3184497886289,5.8174,2.8794,5
"7936",1,15,28,13,-2.15517040098119,-18.1826,-13.1206,-3
"7937",1,26,20,-6,-21.3673916901101,0.8174,-5.1206,8
"7938",1,23,21,-2,-16.5492134886948,-3.1826,-6.1206,5
"7939",1,23,2,-21,-28.3092828540895,15.8174,12.8794,5
"7940",1,25,30,5,-14.0787088301044,-10.1826,-15.1206,7
"7941",1,10,3,-7,-10.7285389612072,1.8174,11.8794,-8
"7942",1,22,29,7,-10.7789501161201,-12.1826,-14.1206,4
"7943",1,16,15,-1,-11.2264747145,-4.1826,-0.1206,-2
"7944",1,22,28,6,-11.2911322359276,-11.1826,-13.1206,4
"7945",1,24,13,-11,-23.1720233905372,5.8174,1.8794,6
"7946",1,22,21,-1,-15.5456868644277,-4.1826,-6.1206,4
"7947",1,16,18,2,-9.59212213502103,-7.1826,-3.1206,-2
"7948",1,21,20,-1,-14.6375603130766,-4.1826,-5.1206,3
"7949",1,17,6,-11,-17.8157230867951,5.8174,8.8794,-1
"7950",1,15,2,-13,-17.6897223768152,7.8174,12.8794,-3
"7951",1,21,1,-20,-26.1589765074768,14.8174,13.8794,3
"7952",1,23,7,-16,-25.0385996953945,10.8174,7.8794,5
"7953",1,26,11,-15,-26.4996078673946,9.8174,3.8794,8
"7954",1,25,5,-20,-28.9173333231172,14.8174,9.8794,7
"7955",1,27,3,-24,-32.7383052184929,18.8174,11.8794,9
"7956",1,16,24,8,-5.78144692330681,-13.1826,-9.1206,-2
"7957",1,28,5,-23,-32.9084106645251,17.8174,9.8794,10
"7958",1,26,6,-20,-29.6863633589185,14.8174,8.8794,8
"7959",1,19,22,3,-10.7091771038214,-8.1826,-7.1206,1
"7960",1,21,25,4,-11.7763239500146,-9.1826,-10.1206,3
"7961",1,22,2,-20,-26.6735694400944,14.8174,12.8794,4
"7962",1,14,14,0,-9.31555549019217,-5.1826,0.8794,-4
"7963",1,10,23,13,1.33804155891278,-18.1826,-8.1206,-8
"7964",1,21,4,-17,-24.4943181601566,11.8174,10.8794,3
"7965",1,26,13,-13,-25.4886366694916,7.8174,1.8794,8
"7966",1,12,19,7,-3.59929214400656,-12.1826,-4.1206,-6
"7967",1,19,23,4,-10.4717115171849,-9.1826,-8.1206,1
"7968",1,18,7,-11,-19.0011150754803,5.8174,7.8794,0
"7969",1,24,2,-22,-29.4904693640188,16.8174,12.8794,6
"7970",1,18,10,-8,-16.9957721409158,2.8174,4.8794,0
"7971",1,25,19,-6,-20.7721984745668,0.8174,-4.1206,7
"7972",1,19,16,-3,-14.8169904884918,-2.1826,-1.1206,1
"7973",1,12,23,11,-1.25804136326406,-16.1826,-8.1206,-6
"7974",1,22,26,4,-12.5036008288797,-9.1826,-11.1206,4
"7975",1,12,22,10,-1.93142838813101,-15.1826,-7.1206,-6
"7976",1,26,26,0,-17.9408699471936,-5.1826,-11.1206,8
"7977",1,19,30,11,-6.41510234789098,-16.1826,-15.1206,1
"7978",1,20,23,3,-11.7867616698423,-8.1826,-8.1206,2
"7979",1,19,20,1,-12.0672088570456,-6.1826,-5.1206,1
"7980",1,25,13,-12,-24.5723389764081,6.8174,1.8794,7
"7981",1,7,15,8,0.197153962535264,-13.1826,-0.1206,-11
"7982",1,21,7,-14,-22.4772070510788,8.8174,7.8794,3
"7983",1,15,14,-1,-10.6722538055124,-4.1826,0.8794,-3
"7984",1,21,2,-19,-25.3809128661528,13.8174,12.8794,3
"7985",1,23,17,-6,-19.134113972697,0.8174,-2.1206,5
"7986",1,24,1,-23,-30.0564846573036,17.8174,13.8794,6
"7987",1,14,0,-14,-17.7659319355976,8.8174,14.8794,-4
"7988",1,18,18,0,-12.0968331584707,-5.1826,-3.1206,0
"7989",1,25,5,-20,-29.0879677311719,14.8174,9.8794,7
"7990",1,21,16,-5,-17.2510608042109,-0.1826,-1.1206,3
"7991",1,20,2,-18,-24.6301845902854,12.8174,12.8794,2
"7992",1,15,24,9,-4.37782148402672,-14.1826,-9.1206,-3
"7993",1,36,4,-32,-43.5762409248557,26.8174,10.8794,18
"7994",1,20,19,-1,-13.9181553456037,-4.1826,-4.1206,2
"7995",1,14,12,-2,-10.3716254387791,-3.1826,2.8794,-4
"7996",1,22,6,-16,-24.5718190785594,10.8174,8.8794,4
"7997",1,15,7,-8,-14.6569069436029,2.8174,7.8794,-3
"7998",1,23,1,-22,-28.4704853509655,16.8174,13.8794,5
"7999",1,16,27,11,-4.28852745625641,-16.1826,-12.1206,-2
"8000",1,17,17,0,-11.2232419103733,-5.1826,-2.1206,-1
"8001",1,25,3,-22,-30.1285630949545,16.8174,11.8794,7
"8002",1,17,6,-11,-18.1363309072236,5.8174,8.8794,-1
"8003",1,20,18,-2,-14.9420809253551,-3.1826,-3.1206,2
"8004",1,23,24,1,-15.1518855479971,-6.1826,-9.1206,5
"8005",1,20,3,-17,-23.7153846217465,11.8174,11.8794,2
"8006",1,19,26,7,-8.85632353836329,-12.1826,-11.1206,1
"8007",1,23,21,-2,-16.4681482754291,-3.1826,-6.1206,5
"8008",1,13,24,11,-1.97810354443479,-16.1826,-9.1206,-5
"8009",1,18,17,-1,-12.7814307969777,-4.1826,-2.1206,0
"8010",1,19,6,-13,-20.7390756212337,7.8174,8.8794,1
"8011",1,18,6,-12,-19.2053448178235,6.8174,8.8794,0
"8012",1,24,21,-3,-18.0288477201947,-2.1826,-6.1206,6
"8013",1,20,25,5,-10.5014383524832,-10.1826,-10.1206,2
"8014",1,30,1,-29,-37.9781064780127,23.8174,13.8794,12
"8015",1,20,24,4,-11.1637635601638,-9.1826,-9.1206,2
"8016",1,20,9,-11,-20.0716655929124,5.8174,5.8794,2
"8017",1,24,12,-12,-23.3664330720369,6.8174,2.8794,6
"8018",1,27,25,-2,-19.4390168882883,-3.1826,-10.1206,9
"8019",1,20,1,-19,-24.8964501072241,13.8174,13.8794,2
"8020",1,26,1,-25,-32.6783095706121,19.8174,13.8794,8
"8021",1,24,1,-23,-30.0351578954293,17.8174,13.8794,6
"8022",1,12,13,1,-7.14653188544834,-6.1826,1.8794,-6
"8023",1,19,2,-17,-22.8163378664358,11.8174,12.8794,1
"8024",1,13,26,13,-0.899343292183977,-18.1826,-11.1206,-5
"8025",1,12,2,-10,-14.0852255964739,4.8174,12.8794,-6
"8026",1,21,28,7,-10.0013204984437,-12.1826,-13.1206,3
"8027",1,23,2,-21,-28.0419837242568,15.8174,12.8794,5
"8028",1,25,9,-16,-26.8334638256251,10.8174,5.8794,7
"8029",1,21,3,-18,-24.9737926865942,12.8174,11.8794,3
"8030",1,22,21,-1,-15.44287586884,-4.1826,-6.1206,4
"8031",1,16,15,-1,-11.1171342114668,-4.1826,-0.1206,-2
"8032",1,20,7,-13,-21.1623160744131,7.8174,7.8794,2
"8033",1,32,1,-31,-40.5629477370993,25.8174,13.8794,14
"8034",1,17,8,-9,-16.8651766293768,3.8174,6.8794,-1
"8035",1,27,2,-25,-33.3952571162251,19.8174,12.8794,9
"8036",1,17,22,5,-8.22579039635066,-10.1826,-7.1206,-1
"8037",1,30,20,-10,-26.662592304129,4.8174,-5.1206,12
"8038",1,19,30,11,-6.32785089710722,-16.1826,-15.1206,1
"8039",1,25,1,-24,-31.4134812934841,18.8174,13.8794,7
"8040",1,24,29,5,-13.4813703862708,-10.1826,-14.1206,6
"8041",1,19,15,-4,-15.2337094940418,-1.1826,-0.1206,1
"8042",1,17,6,-11,-18.0525004124444,5.8174,8.8794,-1
"8043",1,17,29,12,-4.37053422451408,-17.1826,-14.1206,-1
"8044",1,17,9,-8,-16.302892855204,2.8174,5.8794,-1
"8045",1,20,30,10,-7.24875738646845,-15.1826,-15.1206,2
"8046",1,18,6,-12,-19.3600963042535,6.8174,8.8794,0
"8047",1,16,17,1,-10.3271559142423,-6.1826,-2.1206,-2
"8048",1,17,11,-6,-15.1320146139899,0.8174,3.8794,-1
"8049",1,19,5,-14,-20.9379600050322,8.8174,9.8794,1
"8050",1,15,21,6,-6.58588236289293,-11.1826,-6.1206,-3
"8051",1,20,29,9,-8.09850564704985,-14.1826,-14.1206,2
"8052",1,18,15,-3,-13.7386995484385,-2.1826,-0.1206,0
"8053",1,24,21,-3,-18.1279289858402,-2.1826,-6.1206,6
"8054",1,24,17,-7,-20.3823623078384,1.8174,-2.1206,6
"8055",1,24,6,-18,-27.283330679549,12.8174,8.8794,6
"8056",1,17,4,-13,-19.0872201152601,7.8174,10.8794,-1
"8057",1,19,2,-17,-23.0665064215579,11.8174,12.8794,1
"8058",1,22,4,-18,-25.5549358276305,12.8174,10.8794,4
"8059",1,7,19,12,2.89013303328397,-17.1826,-4.1206,-11
"8060",1,16,6,-10,-16.8754105578885,4.8174,8.8794,-2
"8061",1,20,29,9,-7.99191919333862,-14.1826,-14.1206,2
"8062",1,21,11,-10,-20.089651307969,4.8174,3.8794,3
"8063",1,17,28,11,-4.48286471206308,-16.1826,-13.1206,-1
"8064",1,23,12,-11,-21.9097479308839,5.8174,2.8794,5
"8065",1,32,30,-2,-23.3019459920293,-3.1826,-15.1206,14
"8066",1,29,5,-24,-34.0522926225715,18.8174,9.8794,11
"8067",1,15,30,15,-0.607898588122202,-20.1826,-15.1206,-3
"8068",1,16,3,-13,-18.4927505120935,7.8174,11.8794,-2
"8069",1,26,25,-1,-18.3012623439887,-4.1826,-10.1206,8
"8070",1,33,15,-18,-33.4488926358517,12.8174,-0.1206,15
"8071",1,15,29,14,-1.47841070908209,-19.1826,-14.1206,-3
"8072",1,19,11,-8,-17.6089677032166,2.8174,3.8794,1
"8073",1,24,25,1,-15.2293653158954,-6.1826,-10.1206,6
"8074",1,21,15,-6,-17.8303099027423,0.8174,-0.1206,3
"8075",1,16,0,-16,-20.2630029552326,10.8174,14.8794,-2
"8076",1,19,25,6,-9.17165823388235,-11.1826,-10.1206,1
"8077",1,13,25,12,-1.29693239923964,-17.1826,-10.1206,-5
"8078",1,18,7,-11,-18.8240516962804,5.8174,7.8794,0
"8079",1,18,12,-6,-15.6302770250458,0.8174,2.8794,0
"8080",1,22,2,-20,-26.9609379148131,14.8174,12.8794,4
"8081",1,15,5,-10,-16.1163303967793,4.8174,9.8794,-3
"8082",1,19,5,-14,-20.9401070950759,8.8174,9.8794,1
"8083",1,23,24,1,-15.2391185103023,-6.1826,-9.1206,5
"8084",1,20,8,-12,-20.736654388558,6.8174,6.8794,2
"8085",1,28,19,-9,-24.6211192787406,3.8174,-4.1206,10
"8086",1,28,8,-20,-30.8544078776026,14.8174,6.8794,10
"8087",1,20,18,-2,-14.6061958345696,-3.1826,-3.1206,2
"8088",1,17,5,-12,-18.4461631783021,6.8174,9.8794,-1
"8089",1,15,2,-13,-17.9767366394757,7.8174,12.8794,-3
"8090",1,16,21,5,-7.70522137715885,-10.1826,-6.1206,-2
"8091",1,24,7,-17,-26.5390804147245,11.8174,7.8794,6
"8092",1,22,6,-16,-24.5133059161913,10.8174,8.8794,4
"8093",1,19,4,-15,-22.1387749946064,9.8174,10.8794,1
"8094",1,26,0,-26,-33.3715419343806,20.8174,14.8794,8
"8095",1,14,27,13,-1.56986591018125,-18.1826,-12.1206,-4
"8096",1,27,2,-25,-33.2677867260508,19.8174,12.8794,9
"8097",1,23,13,-10,-21.3658739230258,4.8174,1.8794,5
"8098",1,25,24,-1,-17.7070171790012,-4.1826,-9.1206,7
"8099",1,23,8,-15,-24.7726467615783,9.8174,6.8794,5
"8100",1,21,23,2,-13.2489986036284,-7.1826,-8.1206,3
"8101",1,24,23,-1,-17.1282717064912,-4.1826,-8.1206,6
"8102",1,30,4,-26,-35.9579307630844,20.8174,10.8794,12
"8103",1,15,23,8,-5.1246493254544,-13.1826,-8.1206,-3
"8104",1,21,2,-19,-25.6239351968966,13.8174,12.8794,3
"8105",1,29,30,1,-19.3051292058491,-6.1826,-15.1206,11
"8106",1,23,10,-13,-23.4310108602622,7.8174,4.8794,5
"8107",1,26,24,-2,-18.9743656724238,-3.1826,-9.1206,8
"8108",1,21,5,-16,-23.9311797426478,10.8174,9.8794,3
"8109",1,18,29,11,-5.74406649710112,-16.1826,-14.1206,0
"8110",1,23,22,-1,-16.1642162231082,-4.1826,-7.1206,5
"8111",1,14,26,12,-2.13283928525215,-17.1826,-11.1206,-4
"8112",1,19,19,0,-13.0066051078701,-5.1826,-4.1206,1
"8113",1,15,26,11,-3.29953485968179,-16.1826,-11.1206,-3
"8114",1,21,28,7,-10.0765690560458,-12.1826,-13.1206,3
"8115",1,15,25,10,-3.95905163656996,-15.1826,-10.1206,-3
"8116",1,17,27,10,-5.40149017451455,-15.1826,-12.1206,-1
"8117",1,23,29,6,-12.0101664445132,-11.1826,-14.1206,5
"8118",1,24,26,2,-15.1142003679078,-7.1826,-11.1206,6
"8119",1,17,2,-15,-20.6293713186386,9.8174,12.8794,-1
"8120",1,22,25,3,-13.0811056544355,-8.1826,-10.1206,4
"8121",1,23,25,2,-14.7178449916259,-7.1826,-10.1206,5
"8122",1,20,1,-19,-24.6296433769081,13.8174,13.8794,2
"8123",1,21,11,-10,-20.1871281176384,4.8174,3.8794,3
"8124",1,18,16,-2,-13.2131507127208,-3.1826,-1.1206,0
"8125",1,19,12,-7,-16.9745770323156,1.8174,2.8794,1
"8126",1,20,9,-11,-19.9976316777616,5.8174,5.8794,2
"8127",1,18,2,-16,-21.9901499159768,10.8174,12.8794,0
"8128",1,17,24,7,-7.16247658517888,-12.1826,-9.1206,-1
"8129",1,27,10,-17,-28.5719381573824,11.8174,4.8794,9
"8130",1,27,1,-26,-34.0592957376474,20.8174,13.8794,9
"8131",1,24,19,-5,-19.6169860497614,-0.1826,-4.1206,6
"8132",1,17,23,6,-7.87865279839945,-11.1826,-8.1206,-1
"8133",1,19,28,9,-7.753191896741,-14.1826,-13.1206,1
"8134",1,15,29,14,-1.51049454616168,-19.1826,-14.1206,-3
"8135",1,20,7,-13,-21.3420869944692,7.8174,7.8794,2
"8136",1,19,11,-8,-17.496558938765,2.8174,3.8794,1
"8137",1,25,9,-16,-26.5194989940431,10.8174,5.8794,7
"8138",1,18,0,-18,-22.9275401994985,12.8174,14.8794,0
"8139",1,17,26,9,-6.01887075168211,-14.1826,-11.1206,-1
"8140",1,23,14,-9,-20.9974492527111,3.8174,0.8794,5
"8141",1,25,9,-16,-26.5303934025716,10.8174,5.8794,7
"8142",1,14,2,-12,-16.1985418670262,6.8174,12.8794,-4
"8143",1,24,28,4,-13.8046194433822,-9.1826,-13.1206,6
"8144",1,30,25,-5,-23.4754478438101,-0.1826,-10.1206,12
"8145",1,14,13,-1,-9.93811266950552,-4.1826,1.8794,-4
"8146",1,20,8,-12,-20.5895362045551,6.8174,6.8794,2
"8147",1,13,17,4,-6.07607983910515,-9.1826,-2.1206,-5
"8148",1,24,22,-2,-17.7697647357675,-3.1826,-7.1206,6
"8149",1,23,13,-10,-21.4664665963819,4.8174,1.8794,5
"8150",1,16,22,6,-7.38284859233339,-11.1826,-7.1206,-2
"8151",1,24,10,-14,-24.8152641388812,8.8174,4.8794,6
"8152",1,19,23,4,-10.6355735694611,-9.1826,-8.1206,1
"8153",1,22,25,3,-13.1561675084591,-8.1826,-10.1206,4
"8154",1,17,16,-1,-12.2613613675033,-4.1826,-1.1206,-1
"8155",1,17,22,5,-8.16275394128598,-10.1826,-7.1206,-1
"8156",1,15,16,1,-9.3940554874807,-6.1826,-1.1206,-3
"8157",1,21,12,-9,-19.3927880142829,3.8174,2.8794,3
"8158",1,22,16,-6,-18.6901204861956,0.8174,-1.1206,4
"8159",1,26,17,-9,-22.9770404591247,3.8174,-2.1206,8
"8160",1,18,7,-11,-18.7561296849612,5.8174,7.8794,0
"8161",1,17,17,0,-11.4840081140853,-5.1826,-2.1206,-1
"8162",1,19,29,10,-7.28926731000591,-15.1826,-14.1206,1
"8163",1,23,19,-4,-18.1124186375973,-1.1826,-4.1206,5
"8164",1,23,20,-3,-17.3520303651777,-2.1826,-5.1206,5
"8165",1,19,3,-16,-22.4956827560901,10.8174,11.8794,1
"8166",1,17,17,0,-11.4127074991767,-5.1826,-2.1206,-1
"8167",1,24,24,0,-16.3867974577908,-5.1826,-9.1206,6
"8168",1,24,25,1,-15.6818371837986,-6.1826,-10.1206,6
"8169",1,24,24,0,-16.4522815879133,-5.1826,-9.1206,6
"8170",1,21,21,0,-14.3829177278439,-5.1826,-6.1206,3
"8171",1,19,16,-3,-14.7399449301724,-2.1826,-1.1206,1
"8172",1,25,7,-18,-28.0525101312486,12.8174,7.8794,7
"8173",1,17,9,-8,-16.4880775562801,2.8174,5.8794,-1
"8174",1,22,28,6,-11.0480906784596,-11.1826,-13.1206,4
"8175",1,9,22,13,2.02501613361707,-18.1826,-7.1206,-9
"8176",1,28,27,-1,-19.988786969775,-4.1826,-12.1206,10
"8177",1,25,2,-23,-30.4545040579146,17.8174,12.8794,7
"8178",1,22,18,-4,-17.4296367559911,-1.1826,-3.1206,4
"8179",1,21,21,0,-14.0617982291937,-5.1826,-6.1206,3
"8180",1,25,19,-6,-20.6966135750062,0.8174,-4.1206,7
"8181",1,26,21,-5,-20.8471563314794,-0.1826,-6.1206,8
"8182",1,19,2,-17,-22.7141702071495,11.8174,12.8794,1
"8183",1,16,27,11,-3.88971392977024,-16.1826,-12.1206,-2
"8184",1,14,22,8,-4.34560550299134,-13.1826,-7.1206,-4
"8185",1,20,16,-4,-15.7843725525667,-1.1826,-1.1206,2
"8186",1,19,28,9,-7.2959097045589,-14.1826,-13.1206,1
"8187",1,15,29,14,-1.57327359165111,-19.1826,-14.1206,-3
"8188",1,23,3,-20,-27.8061507882929,14.8174,11.8794,5
"8189",1,16,24,8,-5.83496402192744,-13.1826,-9.1206,-2
"8190",1,27,25,-2,-19.609199533303,-3.1826,-10.1206,9
"8191",1,22,7,-15,-23.9590971045905,9.8174,7.8794,4
"8192",1,19,30,11,-6.32057367494365,-16.1826,-15.1206,1
"8193",1,16,1,-15,-19.484199528456,9.8174,13.8794,-2
"8194",1,17,26,9,-5.95207991330745,-14.1826,-11.1206,-1
"8195",1,11,5,-6,-10.7020071585706,0.8174,9.8794,-7
"8196",1,11,2,-9,-12.3719617911609,3.8174,12.8794,-7
"8197",1,20,12,-8,-18.218435515921,2.8174,2.8794,2
"8198",1,16,23,7,-6.48413284685181,-12.1826,-8.1206,-2
"8199",1,27,28,1,-17.9807920366845,-6.1826,-13.1206,9
"8200",1,18,9,-9,-17.5217984869247,3.8174,5.8794,0
"8201",1,20,5,-15,-22.516428465718,9.8174,9.8794,2
"8202",1,16,12,-4,-13.4221015690669,-1.1826,2.8794,-2
"8203",1,21,6,-15,-23.132452276916,9.8174,8.8794,3
"8204",1,22,26,4,-12.3794479719365,-9.1826,-11.1206,4
"8205",1,19,5,-14,-21.1854459952925,8.8174,9.8794,1
"8206",1,14,16,2,-8.28781390016335,-7.1826,-1.1206,-4
"8207",1,25,13,-12,-23.9166474942546,6.8174,1.8794,7
"8208",1,27,18,-9,-23.5949098013883,3.8174,-3.1206,9
"8209",1,30,6,-24,-34.7547240231805,18.8174,8.8794,12
"8210",1,22,27,5,-11.8325539077796,-10.1826,-12.1206,4
"8211",1,18,8,-10,-18.1344884837003,4.8174,6.8794,0
"8212",1,24,10,-14,-24.7207764746404,8.8174,4.8794,6
"8213",1,18,0,-18,-22.9099148750497,12.8174,14.8794,0
"8214",1,20,21,1,-12.9329862453897,-6.1826,-6.1206,2
"8215",1,22,27,5,-11.9722595372604,-10.1826,-12.1206,4
"8216",1,19,16,-3,-14.6836165919593,-2.1826,-1.1206,1
"8217",1,18,20,2,-10.822757061884,-7.1826,-5.1206,0
"8218",1,26,17,-9,-23.1503029168438,3.8174,-2.1206,8
"8219",1,14,14,0,-9.36471077578627,-5.1826,0.8794,-4
"8220",1,16,14,-2,-11.8190691897835,-3.1826,0.8794,-2
"8221",1,36,17,-19,-36.1693498356101,13.8174,-2.1206,18
"8222",1,21,11,-10,-20.4541401144539,4.8174,3.8794,3
"8223",1,21,18,-3,-16.209409042336,-2.1826,-3.1206,3
"8224",1,24,11,-13,-24.154577810797,7.8174,3.8794,6
"8225",1,22,16,-6,-18.5516064104318,0.8174,-1.1206,4
"8226",1,17,29,12,-4.18778559930343,-17.1826,-14.1206,-1
"8227",1,25,26,1,-16.2096027225219,-6.1826,-11.1206,7
"8228",1,24,20,-4,-18.9520319324936,-1.1826,-5.1206,6
"8229",1,19,21,2,-11.2932892176243,-7.1826,-6.1206,1
"8230",1,19,23,4,-10.4219474303993,-9.1826,-8.1206,1
"8231",1,16,29,13,-2.69993018900195,-18.1826,-14.1206,-2
"8232",1,26,5,-21,-30.4470286290556,15.8174,9.8794,8
"8233",1,16,1,-15,-19.660989752897,9.8174,13.8794,-2
"8234",1,20,3,-17,-23.5234361168239,11.8174,11.8794,2
"8235",1,13,9,-4,-10.8742738797567,-1.1826,5.8794,-5
"8236",1,13,15,2,-7.54045473975021,-7.1826,-0.1206,-5
"8237",1,24,2,-22,-29.5129352079215,16.8174,12.8794,6
"8238",1,17,4,-13,-18.961396862854,7.8174,10.8794,-1
"8239",1,15,16,1,-9.30460082261112,-6.1826,-1.1206,-3
"8240",1,20,19,-1,-14.0101428487116,-4.1826,-4.1206,2
"8241",1,28,5,-23,-32.9801904323764,17.8174,9.8794,10
"8242",1,24,27,3,-14.5810642735821,-8.1826,-12.1206,6
"8243",1,27,0,-27,-34.640205883381,21.8174,14.8794,9
"8244",1,27,23,-4,-20.7184749190534,-1.1826,-8.1206,9
"8245",1,17,14,-3,-13.2778845333858,-2.1826,0.8794,-1
"8246",1,14,20,6,-5.75026326219815,-11.1826,-5.1206,-4
"8247",1,26,4,-22,-30.7605684604844,16.8174,10.8794,8
"8248",1,18,26,8,-7.44201489490342,-13.1826,-11.1206,0
"8249",1,28,6,-22,-32.3750962321905,16.8174,8.8794,10
"8250",1,24,12,-12,-23.3655824518017,6.8174,2.8794,6
"8251",1,14,29,15,-0.329640230399764,-20.1826,-14.1206,-4
"8252",1,21,26,5,-11.1852219879885,-10.1826,-11.1206,3
"8253",1,20,3,-17,-23.4593410733384,11.8174,11.8794,2
"8254",1,19,6,-13,-20.4807937184957,7.8174,8.8794,1
"8255",1,28,9,-19,-30.5221783548972,13.8174,5.8794,10
"8256",1,26,16,-10,-23.8450741320113,4.8174,-1.1206,8
"8257",1,18,5,-13,-20.062687114911,7.8174,9.8794,0
"8258",1,24,25,1,-15.7199474032512,-6.1826,-10.1206,6
"8259",1,24,17,-7,-20.2786665821767,1.8174,-2.1206,6
"8260",1,22,17,-5,-18.2255738657466,-0.1826,-2.1206,4
"8261",1,22,23,1,-13.9867195360293,-6.1826,-8.1206,4
"8262",1,25,13,-12,-24.16401421128,6.8174,1.8794,7
"8263",1,18,13,-5,-15.2030525377077,-0.1826,1.8794,0
"8264",1,27,27,0,-18.1565190032573,-5.1826,-12.1206,9
"8265",1,23,29,6,-12.0258500807293,-11.1826,-14.1206,5
"8266",1,18,6,-12,-19.3235108425967,6.8174,8.8794,0
"8267",1,18,5,-13,-19.9579196807724,7.8174,9.8794,0
"8268",1,27,25,-2,-19.5468094022924,-3.1826,-10.1206,9
"8269",1,19,17,-2,-13.8226691383503,-3.1826,-2.1206,1
"8270",1,24,2,-22,-29.4525235927948,16.8174,12.8794,6
"8271",1,18,23,5,-8.88552116765481,-10.1826,-8.1206,0
"8272",1,17,24,7,-7.33512904588703,-12.1826,-9.1206,-1
"8273",1,25,25,0,-16.5547199196454,-5.1826,-10.1206,7
"8274",1,30,3,-27,-36.5245415442759,21.8174,11.8794,12
"8275",1,21,24,3,-12.3277436277538,-8.1826,-9.1206,3
"8276",1,17,1,-16,-21.4597630980966,10.8174,13.8794,-1
"8277",1,12,11,-1,-8.34166071631149,-4.1826,3.8794,-6
"8278",1,19,2,-17,-22.9990983456209,11.8174,12.8794,1
"8279",1,16,17,1,-10.3588249341242,-6.1826,-2.1206,-2
"8280",1,32,14,-18,-32.6180292221442,12.8174,0.8794,14
"8281",1,19,14,-5,-15.9700126593414,-0.1826,0.8794,1
"8282",1,14,23,9,-3.7125161438437,-14.1826,-8.1206,-4
"8283",1,26,28,2,-16.5744898276957,-7.1826,-13.1206,8
"8284",1,20,11,-9,-18.9792443560818,3.8174,3.8794,2
"8285",1,21,25,4,-11.7173151956558,-9.1826,-10.1206,3
"8286",1,17,26,9,-5.68401146998901,-14.1826,-11.1206,-1
"8287",1,26,22,-4,-19.9925614442313,-1.1826,-7.1206,8
"8288",1,23,28,5,-12.3851843096286,-10.1826,-13.1206,5
"8289",1,17,16,-1,-12.2384024107274,-4.1826,-1.1206,-1
"8290",1,23,16,-7,-20.0566452808741,1.8174,-1.1206,5
"8291",1,20,28,8,-9.0585367906376,-13.1826,-13.1206,2
"8292",1,27,0,-27,-34.647126447546,21.8174,14.8794,9
"8293",1,18,5,-13,-20.048683826249,7.8174,9.8794,0
"8294",1,23,23,0,-15.62451968159,-5.1826,-8.1206,5
"8295",1,24,8,-16,-26.1160919496894,10.8174,6.8794,6
"8296",1,17,13,-4,-13.8416076286951,-1.1826,1.8794,-1
"8297",1,13,23,10,-2.47034720295147,-15.1826,-8.1206,-5
"8298",1,21,3,-18,-25.1389320914863,12.8174,11.8794,3
"8299",1,11,28,17,2.89700490463737,-22.1826,-13.1206,-7
"8300",1,28,24,-4,-21.7689821975399,-1.1826,-9.1206,10
"8301",1,17,14,-3,-13.2022164104624,-2.1826,0.8794,-1
"8302",1,24,28,4,-13.6291976837761,-9.1826,-13.1206,6
"8303",1,26,19,-7,-21.837029837568,1.8174,-4.1206,8
"8304",1,15,1,-14,-18.1547068494666,8.8174,13.8794,-3
"8305",1,20,2,-18,-24.1483068275354,12.8174,12.8794,2
"8306",1,18,1,-17,-22.4629315288405,11.8174,13.8794,0
"8307",1,26,10,-16,-27.0186097896043,10.8174,4.8794,8
"8308",1,28,30,2,-18.1816779456378,-7.1826,-15.1206,10
"8309",1,10,13,3,-4.46748745053344,-8.1826,1.8794,-8
"8310",1,14,5,-9,-14.7136275183597,3.8174,9.8794,-4
"8311",1,25,2,-23,-30.6586722068045,17.8174,12.8794,7
"8312",1,25,2,-23,-30.6102493712931,17.8174,12.8794,7
"8313",1,17,9,-8,-16.0783880785119,2.8174,5.8794,-1
"8314",1,22,14,-8,-19.6636452392873,2.8174,0.8794,4
"8315",1,26,29,3,-16.1354069387917,-8.1826,-14.1206,8
"8316",1,29,8,-21,-32.4852390350414,15.8174,6.8794,11
"8317",1,26,7,-19,-29.0938085217379,13.8174,7.8794,8
"8318",1,20,13,-7,-17.6858395538341,1.8174,1.8794,2
"8319",1,16,8,-8,-15.5192315820544,2.8174,6.8794,-2
"8320",1,27,27,0,-18.4736591821049,-5.1826,-12.1206,9
"8321",1,15,12,-3,-11.6941165263927,-2.1826,2.8794,-3
"8322",1,12,30,18,3.00250969799006,-23.1826,-15.1206,-6
"8323",1,26,20,-6,-21.4523839061143,0.8174,-5.1206,8
"8324",1,21,10,-11,-20.6832412676378,5.8174,4.8794,3
"8325",1,18,12,-6,-15.5711216371738,0.8174,2.8794,0
"8326",1,24,5,-19,-27.7900053452569,13.8174,9.8794,6
"8327",1,16,26,10,-4.59985307147287,-15.1826,-11.1206,-2
"8328",1,20,25,5,-10.7370583071799,-10.1826,-10.1206,2
"8329",1,25,26,1,-16.2739539409627,-6.1826,-11.1206,7
"8330",1,27,22,-5,-21.40481444927,-0.1826,-7.1206,9
"8331",1,21,27,6,-10.698687341311,-11.1826,-12.1206,3
"8332",1,19,6,-13,-20.5800788140218,7.8174,8.8794,1
"8333",1,25,17,-8,-21.9205629501509,2.8174,-2.1206,7
"8334",1,23,10,-13,-23.3661392138463,7.8174,4.8794,5
"8335",1,10,3,-7,-10.5567324120315,1.8174,11.8794,-8
"8336",1,17,24,7,-7.63628826881194,-12.1826,-9.1206,-1
"8337",1,20,30,10,-7.72651853933893,-15.1826,-15.1206,2
"8338",1,22,5,-17,-25.2384067268059,11.8174,9.8794,4
"8339",1,20,25,5,-10.3854119927914,-10.1826,-10.1206,2
"8340",1,21,29,8,-9.2013878911532,-13.1826,-14.1206,3
"8341",1,27,9,-18,-29.1920434118504,12.8174,5.8794,9
"8342",1,15,25,10,-4.1398675920857,-15.1826,-10.1206,-3
"8343",1,16,18,2,-9.6639177766375,-7.1826,-3.1206,-2
"8344",1,15,16,1,-9.45265943095031,-6.1826,-1.1206,-3
"8345",1,19,14,-5,-15.9327381686255,-0.1826,0.8794,1
"8346",1,19,1,-18,-23.5560440161601,12.8174,13.8794,1
"8347",1,26,16,-10,-23.5198684920847,4.8174,-1.1206,8
"8348",1,24,30,6,-12.5503352380832,-11.1826,-15.1206,6
"8349",1,23,8,-15,-24.6108083749234,9.8174,6.8794,5
"8350",1,20,30,10,-7.35114858697213,-15.1826,-15.1206,2
"8351",1,28,28,0,-19.2036708800846,-5.1826,-13.1206,10
"8352",1,19,0,-19,-24.2094436118774,13.8174,14.8794,1
"8353",1,20,13,-7,-17.6443571596857,1.8174,1.8794,2
"8354",1,16,16,0,-10.8710152706529,-5.1826,-1.1206,-2
"8355",1,24,10,-14,-24.758415222202,8.8174,4.8794,6
"8356",1,24,0,-24,-30.7443382705215,18.8174,14.8794,6
"8357",1,30,8,-22,-33.7970096551098,16.8174,6.8794,12
"8358",1,24,17,-7,-20.3241155456196,1.8174,-2.1206,6
"8359",1,20,13,-7,-17.6842648184039,1.8174,1.8794,2
"8360",1,24,3,-21,-28.9772488500394,15.8174,11.8794,6
"8361",1,20,22,2,-12.5298783080827,-7.1826,-7.1206,2
"8362",1,16,17,1,-10.1069626457995,-6.1826,-2.1206,-2
"8363",1,15,4,-11,-16.6544500410084,5.8174,10.8794,-3
"8364",1,21,14,-7,-18.1122858871457,1.8174,0.8794,3
"8365",1,21,19,-2,-15.365461078298,-3.1826,-4.1206,3
"8366",1,18,30,12,-4.9548171631404,-17.1826,-15.1206,0
"8367",1,20,29,9,-8.12222040346081,-14.1826,-14.1206,2
"8368",1,15,28,13,-2.3479389835278,-18.1826,-13.1206,-3
"8369",1,27,12,-15,-27.5879549549575,9.8174,2.8794,9
"8370",1,22,11,-11,-21.3750120147106,5.8174,3.8794,4
"8371",1,14,2,-12,-16.6301009916871,6.8174,12.8794,-4
"8372",1,25,18,-7,-21.4443453667614,1.8174,-3.1206,7
"8373",1,22,1,-21,-27.6200207163933,15.8174,13.8794,4
"8374",1,24,3,-21,-28.6746613050181,15.8174,11.8794,6
"8375",1,16,3,-13,-18.286333252144,7.8174,11.8794,-2
"8376",1,23,3,-20,-27.7432274649346,14.8174,11.8794,5
"8377",1,14,0,-14,-17.570092546834,8.8174,14.8794,-4
"8378",1,30,13,-17,-30.607434939646,11.8174,1.8794,12
"8379",1,19,20,1,-11.8345482579501,-6.1826,-5.1206,1
"8380",1,28,9,-19,-30.5747366128124,13.8174,5.8794,10
"8381",1,20,20,0,-13.5948482409751,-5.1826,-5.1206,2
"8382",1,26,11,-15,-27.0680986900076,9.8174,3.8794,8
"8383",1,23,15,-8,-20.4895467902433,2.8174,-0.1206,5
"8384",1,18,26,8,-7.35396572181592,-13.1826,-11.1206,0
"8385",1,13,23,10,-2.60694595220632,-15.1826,-8.1206,-5
"8386",1,20,10,-10,-19.7618803083318,4.8174,4.8794,2
"8387",1,15,14,-1,-10.3832659753393,-4.1826,0.8794,-3
"8388",1,23,10,-13,-23.1980406909137,7.8174,4.8794,5
"8389",1,18,4,-14,-20.5660446488515,8.8174,10.8794,0
"8390",1,14,10,-4,-11.6503272890609,-1.1826,4.8794,-4
"8391",1,20,11,-9,-18.8349913748325,3.8174,3.8794,2
"8392",1,19,11,-8,-17.5006313903775,2.8174,3.8794,1
"8393",1,20,3,-17,-23.9802349998694,11.8174,11.8794,2
"8394",1,22,29,7,-10.7794734015975,-12.1826,-14.1206,4
"8395",1,17,17,0,-11.3933161005437,-5.1826,-2.1206,-1
"8396",1,18,14,-4,-14.4133600262687,-1.1826,0.8794,0
"8397",1,21,20,-1,-14.6958283574567,-4.1826,-5.1206,3
"8398",1,16,9,-7,-15.167142392591,1.8174,5.8794,-2
"8399",1,28,6,-22,-32.2441123004544,16.8174,8.8794,10
"8400",1,19,30,11,-6.32091358150656,-16.1826,-15.1206,1
"8401",1,23,17,-6,-19.0931574516269,0.8174,-2.1206,5
"8402",1,21,21,0,-14.2176174989017,-5.1826,-6.1206,3
"8403",1,21,25,4,-11.7059943732607,-9.1826,-10.1206,3
"8404",1,23,16,-7,-19.7440683768389,1.8174,-1.1206,5
"8405",1,20,4,-16,-23.2464014296099,10.8174,10.8794,2
"8406",1,17,7,-10,-17.3185336558234,4.8174,7.8794,-1
"8407",1,13,10,-3,-10.4091860600408,-2.1826,4.8794,-5
"8408",1,25,3,-22,-30.1333800036266,16.8174,11.8794,7
"8409",1,18,24,6,-8.78170956624963,-11.1826,-9.1206,0
"8410",1,17,23,6,-7.92310306653655,-11.1826,-8.1206,-1
"8411",1,14,20,6,-5.55759986054515,-11.1826,-5.1206,-4
"8412",1,23,3,-20,-27.5991806735045,14.8174,11.8794,5
"8413",1,16,2,-14,-19.0827341879975,8.8174,12.8794,-2
"8414",1,24,21,-3,-17.8369047224473,-2.1826,-6.1206,6
"8415",1,27,5,-22,-31.7326710696001,16.8174,9.8794,9
"8416",1,18,17,-1,-12.7507945278018,-4.1826,-2.1206,0
"8417",1,17,4,-13,-19.0256217124942,7.8174,10.8794,-1
"8418",1,15,22,7,-5.92506432887672,-12.1826,-7.1206,-3
"8419",1,21,3,-18,-24.8254529488422,12.8174,11.8794,3
"8420",1,22,11,-11,-21.1657011792745,5.8174,3.8794,4
"8421",1,25,2,-23,-30.8951798393918,17.8174,12.8794,7
"8422",1,19,16,-3,-14.4279715146426,-2.1826,-1.1206,1
"8423",1,23,14,-9,-20.9859465783915,3.8174,0.8794,5
"8424",1,19,21,2,-11.617606589006,-7.1826,-6.1206,1
"8425",1,15,1,-14,-18.5408479161525,8.8174,13.8794,-3
"8426",1,21,28,7,-9.96090491119051,-12.1826,-13.1206,3
"8427",1,18,5,-13,-19.7749686711338,7.8174,9.8794,0
"8428",1,25,16,-9,-22.4162326921682,3.8174,-1.1206,7
"8429",1,23,17,-6,-19.11314515338,0.8174,-2.1206,5
"8430",1,17,30,13,-3.67843510305654,-18.1826,-15.1206,-1
"8431",1,21,19,-2,-15.6328988074644,-3.1826,-4.1206,3
"8432",1,10,20,10,-0.321728991882643,-15.1826,-5.1206,-8
"8433",1,18,19,1,-11.5006590485607,-6.1826,-4.1206,0
"8434",1,14,30,16,0.324096320230191,-21.1826,-15.1206,-4
"8435",1,25,28,3,-15.0776022609143,-8.1826,-13.1206,7
"8436",1,17,11,-6,-15.1382193404315,0.8174,3.8794,-1
"8437",1,26,28,2,-16.5141697475935,-7.1826,-13.1206,8
"8438",1,18,16,-2,-13.1654363749262,-3.1826,-1.1206,0
"8439",1,23,18,-5,-18.6093389729747,-0.1826,-3.1206,5
"8440",1,15,22,7,-5.50604615749707,-12.1826,-7.1206,-3
"8441",1,24,5,-19,-27.4944531493815,13.8174,9.8794,6
"8442",1,18,19,1,-11.47898752868,-6.1826,-4.1206,0
"8443",1,18,13,-5,-15.1086931056096,-0.1826,1.8794,0
"8444",1,23,19,-4,-17.6521677250307,-1.1826,-4.1206,5
"8445",1,18,2,-16,-21.8283442487771,10.8174,12.8794,0
"8446",1,27,2,-25,-33.49676663699,19.8174,12.8794,9
"8447",1,18,24,6,-8.24784387407662,-11.1826,-9.1206,0
"8448",1,21,10,-11,-20.873772954399,5.8174,4.8794,3
"8449",1,17,10,-7,-15.6357969424536,1.8174,4.8794,-1
"8450",1,13,22,9,-3.24519285434844,-14.1826,-7.1206,-5
"8451",1,19,22,3,-11.0678815607954,-8.1826,-7.1206,1
"8452",1,27,21,-6,-21.8786444141261,0.8174,-6.1206,9
"8453",1,23,12,-11,-22.0888745301454,5.8174,2.8794,5
"8454",1,20,29,9,-8.32939825718403,-14.1826,-14.1206,2
"8455",1,17,14,-3,-13.1129708763284,-2.1826,0.8794,-1
"8456",1,22,13,-9,-20.2301720373907,3.8174,1.8794,4
"8457",1,20,11,-9,-19.0804074135157,3.8174,3.8794,2
"8458",1,20,21,1,-12.8145007103635,-6.1826,-6.1206,2
"8459",1,23,28,5,-12.3814681423202,-10.1826,-13.1206,5
"8460",1,22,2,-20,-27.0312767762077,14.8174,12.8794,4
"8461",1,15,26,11,-3.47443804113112,-16.1826,-11.1206,-3
"8462",1,17,3,-14,-19.7722636684008,8.8174,11.8794,-1
"8463",1,17,23,6,-7.5961650257764,-11.1826,-8.1206,-1
"8464",1,21,28,7,-9.85778925067498,-12.1826,-13.1206,3
"8465",1,22,24,2,-13.5444322276617,-7.1826,-9.1206,4
"8466",1,21,3,-18,-25.010494417418,12.8174,11.8794,3
"8467",1,20,14,-6,-17.1561631014829,0.8174,0.8794,2
"8468",1,18,24,6,-8.53205078989653,-11.1826,-9.1206,0
"8469",1,20,30,10,-7.46320762501276,-15.1826,-15.1206,2
"8470",1,17,10,-7,-15.4219310654874,1.8174,4.8794,-1
"8471",1,26,27,1,-17.4034812353973,-6.1826,-12.1206,8
"8472",1,17,14,-3,-13.429790019802,-2.1826,0.8794,-1
"8473",1,20,17,-3,-15.4942314052269,-2.1826,-2.1206,2
"8474",1,16,23,7,-6.81287058036648,-12.1826,-8.1206,-2
"8475",1,25,6,-19,-28.7109083034515,13.8174,8.8794,7
"8476",1,21,23,2,-12.6730056161941,-7.1826,-8.1206,3
"8477",1,19,20,1,-12.4343200843139,-6.1826,-5.1206,1
"8478",1,26,0,-26,-33.3512374685451,20.8174,14.8794,8
"8479",1,10,10,0,-6.61976363808434,-5.1826,4.8794,-8
"8480",1,12,25,13,-0.235952520612642,-18.1826,-10.1206,-6
"8481",1,21,19,-2,-15.4105935447251,-3.1826,-4.1206,3
"8482",1,24,17,-7,-20.5845585852707,1.8174,-2.1206,6
"8483",1,22,27,5,-11.7392782132205,-10.1826,-12.1206,4
"8484",1,22,9,-13,-22.7554981535546,7.8174,5.8794,4
"8485",1,22,13,-9,-20.3015754032122,3.8174,1.8794,4
"8486",1,22,10,-12,-22.0504354300337,6.8174,4.8794,4
"8487",1,27,29,2,-17.271683473265,-7.1826,-14.1206,9
"8488",1,22,0,-22,-28.0422902631022,16.8174,14.8794,4
"8489",1,22,14,-8,-19.6506114181327,2.8174,0.8794,4
"8490",1,18,11,-7,-16.1104400117341,1.8174,3.8794,0
"8491",1,21,29,8,-9.4639227663091,-13.1826,-14.1206,3
"8492",1,27,29,2,-17.1420620368709,-7.1826,-14.1206,9
"8493",1,25,24,-1,-17.8366540151107,-4.1826,-9.1206,7
"8494",1,20,19,-1,-14.006819259543,-4.1826,-4.1206,2
"8495",1,16,19,3,-9.16208126547031,-8.1826,-4.1206,-2
"8496",1,24,2,-22,-29.5916170891127,16.8174,12.8794,6
"8497",1,13,15,2,-7.5406905456702,-7.1826,-0.1206,-5
"8498",1,29,15,-14,-27.9159213722948,8.8174,-0.1206,11
"8499",1,21,0,-21,-26.8537136356389,15.8174,14.8794,3
"8500",1,19,9,-10,-18.7332355448765,4.8174,5.8794,1
"8501",1,20,14,-6,-16.939650243611,0.8174,0.8794,2
"8502",1,18,20,2,-10.9656956366896,-7.1826,-5.1206,0
"8503",1,29,20,-9,-25.1953458122589,3.8174,-5.1206,11
"8504",1,17,9,-8,-16.2901223213398,2.8174,5.8794,-1
"8505",1,25,4,-21,-29.5061867051996,15.8174,10.8794,7
"8506",1,22,11,-11,-21.8566765295494,5.8174,3.8794,4
"8507",1,26,12,-14,-26.0095355018605,8.8174,2.8794,8
"8508",1,14,4,-10,-15.171712357011,4.8174,10.8794,-4
"8509",1,17,18,1,-10.9009015154715,-6.1826,-3.1206,-1
"8510",1,16,3,-13,-18.6290768685852,7.8174,11.8794,-2
"8511",1,22,6,-16,-24.4762939220577,10.8174,8.8794,4
"8512",1,18,18,0,-12.3354164777913,-5.1826,-3.1206,0
"8513",1,27,13,-14,-27.0679722745508,8.8174,1.8794,9
"8514",1,18,19,1,-11.7083405258753,-6.1826,-4.1206,0
"8515",1,22,15,-7,-19.1314152140677,1.8174,-0.1206,4
"8516",1,18,14,-4,-14.8181767079961,-1.1826,0.8794,0
"8517",1,22,19,-3,-16.7043882250814,-2.1826,-4.1206,4
"8518",1,16,8,-8,-15.6643865653221,2.8174,6.8794,-2
"8519",1,17,24,7,-7.10703434269767,-12.1826,-9.1206,-1
"8520",1,17,24,7,-7.39046073132836,-12.1826,-9.1206,-1
"8521",1,15,12,-3,-11.8229868593807,-2.1826,2.8794,-3
"8522",1,24,5,-19,-27.8453340992302,13.8174,9.8794,6
"8523",1,18,17,-1,-12.9206255797077,-4.1826,-2.1206,0
"8524",1,18,20,2,-10.9187618041683,-7.1826,-5.1206,0
"8525",1,21,17,-4,-16.4863398093769,-1.1826,-2.1206,3
"8526",1,13,25,12,-1.48712351662324,-17.1826,-10.1206,-5
"8527",1,16,28,12,-3.81398374015737,-17.1826,-13.1206,-2
"8528",1,14,25,11,-2.92897004299779,-16.1826,-10.1206,-4
"8529",1,12,9,-3,-9.55340456187402,-2.1826,5.8794,-6
"8530",1,19,13,-6,-16.4103037462322,0.8174,1.8794,1
"8531",1,20,0,-20,-25.5078860752786,14.8174,14.8794,2
"8532",1,13,0,-13,-16.4075192059147,7.8174,14.8794,-5
"8533",1,18,24,6,-8.37307885188765,-11.1826,-9.1206,0
"8534",1,24,10,-14,-24.6051640122763,8.8174,4.8794,6
"8535",1,21,28,7,-9.70128007640325,-12.1826,-13.1206,3
"8536",1,15,27,12,-2.60050182829008,-17.1826,-12.1206,-3
"8537",1,22,2,-20,-26.9916093129524,14.8174,12.8794,4
"8538",1,15,6,-9,-15.7048952164832,3.8174,8.8794,-3
"8539",1,22,22,0,-15.0164267048988,-5.1826,-7.1206,4
"8540",1,16,17,1,-10.1037864639829,-6.1826,-2.1206,-2
"8541",1,14,2,-12,-16.3671984530917,6.8174,12.8794,-4
"8542",1,21,10,-11,-20.5795126103112,5.8174,4.8794,3
"8543",1,18,4,-14,-20.6967416260458,8.8174,10.8794,0
"8544",1,19,7,-12,-19.9862220286467,6.8174,7.8794,1
"8545",1,23,20,-3,-17.334991094107,-2.1826,-5.1206,5
"8546",1,17,1,-16,-21.0082108611871,10.8174,13.8794,-1
"8547",1,13,27,14,-0.25006575113096,-19.1826,-12.1206,-5
"8548",1,23,23,0,-15.5476661677861,-5.1826,-8.1206,5
"8549",1,21,12,-9,-19.5668870409869,3.8174,2.8794,3
"8550",1,26,0,-26,-33.3949717778232,20.8174,14.8794,8
"8551",1,22,16,-6,-18.8054238896967,0.8174,-1.1206,4
"8552",1,22,22,0,-14.8893346834151,-5.1826,-7.1206,4
"8553",1,24,2,-22,-29.5267023660244,16.8174,12.8794,6
"8554",1,29,29,0,-19.6069791115526,-5.1826,-14.1206,11
"8555",1,20,23,3,-11.8842310850472,-8.1826,-8.1206,2
"8556",1,13,22,9,-3.08252151576888,-14.1826,-7.1206,-5
"8557",1,20,20,0,-13.6456621946635,-5.1826,-5.1206,2
"8558",1,17,28,11,-4.56416780911563,-16.1826,-13.1206,-1
"8559",1,20,11,-9,-18.9915416080573,3.8174,3.8794,2
"8560",1,22,15,-7,-18.7917286395876,1.8174,-0.1206,4
"8561",1,20,16,-4,-15.8047501250788,-1.1826,-1.1206,2
"8562",1,22,18,-4,-17.3923670985748,-1.1826,-3.1206,4
"8563",1,26,19,-7,-21.8354073944374,1.8174,-4.1206,8
"8564",1,19,18,-1,-13.3787544899659,-4.1826,-3.1206,1
"8565",1,19,13,-6,-16.5044559995315,0.8174,1.8794,1
"8566",1,25,25,0,-17.0861978509344,-5.1826,-10.1206,7
"8567",1,15,14,-1,-10.6877410116172,-4.1826,0.8794,-3
"8568",1,21,19,-2,-15.2953062312583,-3.1826,-4.1206,3
"8569",1,24,30,6,-12.5730582004048,-11.1826,-15.1206,6
"8570",1,18,15,-3,-13.7624927384961,-2.1826,-0.1206,0
"8571",1,30,3,-27,-36.8807383294417,21.8174,11.8794,12
"8572",1,14,6,-8,-14.2779057687844,2.8174,8.8794,-4
"8573",1,23,14,-9,-21.2614581988491,3.8174,0.8794,5
"8574",1,11,1,-10,-13.3216175063037,4.8174,13.8794,-7
"8575",1,32,14,-18,-33.0133709498088,12.8174,0.8794,14
"8576",1,25,24,-1,-17.6183824853333,-4.1826,-9.1206,7
"8577",1,16,9,-7,-14.7636879545335,1.8174,5.8794,-2
"8578",1,16,13,-3,-12.839485784454,-2.1826,1.8794,-2
"8579",1,24,23,-1,-16.9454714753114,-4.1826,-8.1206,6
"8580",1,24,12,-12,-23.5439709387431,6.8174,2.8794,6
"8581",1,17,30,13,-3.6325793903273,-18.1826,-15.1206,-1
"8582",1,25,19,-6,-20.1296700003607,0.8174,-4.1206,7
"8583",1,24,1,-23,-29.9343241667742,17.8174,13.8794,6
"8584",1,20,23,3,-11.5708838791083,-8.1826,-8.1206,2
"8585",1,13,12,-1,-8.92504463109114,-4.1826,2.8794,-5
"8586",1,19,20,1,-12.1425580113479,-6.1826,-5.1206,1
"8587",1,26,26,0,-17.7239153007231,-5.1826,-11.1206,8
"8588",1,20,18,-2,-14.7775466801905,-3.1826,-3.1206,2
"8589",1,23,3,-20,-27.7524016796832,14.8174,11.8794,5
"8590",1,26,16,-10,-23.8002280118925,4.8174,-1.1206,8
"8591",1,13,3,-10,-14.4558700396639,4.8174,11.8794,-5
"8592",1,16,14,-2,-11.9576194089538,-3.1826,0.8794,-2
"8593",1,21,26,5,-11.1245112665176,-10.1826,-11.1206,3
"8594",1,24,17,-7,-20.2638493395671,1.8174,-2.1206,6
"8595",1,19,5,-14,-21.4651584942459,8.8174,9.8794,1
"8596",1,26,10,-16,-27.4380150669563,10.8174,4.8794,8
"8597",1,17,19,2,-10.3928929324737,-7.1826,-4.1206,-1
"8598",1,14,26,12,-2.21105343006152,-17.1826,-11.1206,-4
"8599",1,23,11,-12,-22.713319106322,6.8174,3.8794,5
"8600",1,18,26,8,-7.17029954954732,-13.1826,-11.1206,0
"8601",1,20,19,-1,-14.3053453425321,-4.1826,-4.1206,2
"8602",1,26,24,-2,-19.1766835880321,-3.1826,-9.1206,8
"8603",1,18,29,11,-5.41122259875551,-16.1826,-14.1206,0
"8604",1,24,26,2,-15.2154399575163,-7.1826,-11.1206,6
"8605",1,22,2,-20,-26.7723420062524,14.8174,12.8794,4
"8606",1,26,29,3,-16.066547500102,-8.1826,-14.1206,8
"8607",1,21,24,3,-12.3164962768836,-8.1826,-9.1206,3
"8608",1,21,16,-5,-17.3762222880431,-0.1826,-1.1206,3
"8609",1,21,30,9,-8.73669259346291,-14.1826,-15.1206,3
"8610",1,17,14,-3,-13.1354407515016,-2.1826,0.8794,-1
"8611",1,21,11,-10,-20.1223906664328,4.8174,3.8794,3
"8612",1,16,22,6,-7.23233347675064,-11.1826,-7.1206,-2
"8613",1,26,21,-5,-20.5547208150728,-0.1826,-6.1206,8
"8614",1,25,22,-3,-18.8779198560404,-2.1826,-7.1206,7
"8615",1,19,29,10,-6.84053954011164,-15.1826,-14.1206,1
"8616",1,15,1,-14,-18.765419128159,8.8174,13.8794,-3
"8617",1,18,12,-6,-15.6461588466117,0.8174,2.8794,0
"8618",1,15,23,8,-5.1256914340371,-13.1826,-8.1206,-3
"8619",1,19,29,10,-6.65692394877417,-15.1826,-14.1206,1
"8620",1,22,22,0,-15.0625029235212,-5.1826,-7.1206,4
"8621",1,13,9,-4,-11.2558437501405,-1.1826,5.8794,-5
"8622",1,17,1,-16,-21.1424043005031,10.8174,13.8794,-1
"8623",1,23,22,-1,-16.4913295751695,-4.1826,-7.1206,5
"8624",1,21,24,3,-12.448768250683,-8.1826,-9.1206,3
"8625",1,16,7,-9,-15.675450857617,3.8174,7.8794,-2
"8626",1,17,18,1,-10.8286271349357,-6.1826,-3.1206,-1
"8627",1,18,0,-18,-22.8821204359892,12.8174,14.8794,0
"8628",1,9,20,11,0.76786743294388,-16.1826,-5.1206,-9
"8629",1,22,4,-18,-25.9110133524681,12.8174,10.8794,4
"8630",1,28,10,-18,-29.6244532574068,12.8174,4.8794,10
"8631",1,24,8,-16,-25.6881313728947,10.8174,6.8794,6
"8632",1,22,4,-18,-25.9275042058117,12.8174,10.8794,4
"8633",1,18,2,-16,-21.7954524645213,10.8174,12.8794,0
"8634",1,19,0,-19,-23.9344174872589,13.8174,14.8794,1
"8635",1,18,6,-12,-19.3398907732259,6.8174,8.8794,0
"8636",1,20,29,9,-8.06086907456418,-14.1826,-14.1206,2
"8637",1,20,22,2,-12.1197804494545,-7.1826,-7.1206,2
"8638",1,26,2,-24,-32.3378526857063,18.8174,12.8794,8
"8639",1,23,17,-6,-19.0378787822785,0.8174,-2.1206,5
"8640",1,15,29,14,-1.60573495421068,-19.1826,-14.1206,-3
"8641",1,15,21,6,-6.55146125157459,-11.1826,-6.1206,-3
"8642",1,17,2,-15,-20.6673104890958,9.8174,12.8794,-1
"8643",1,21,4,-17,-24.4213266421262,11.8174,10.8794,3
"8644",1,17,18,1,-10.7648357723784,-6.1826,-3.1206,-1
"8645",1,20,10,-10,-19.8032264542707,4.8174,4.8794,2
"8646",1,26,19,-7,-21.9456603039538,1.8174,-4.1206,8
"8647",1,16,8,-8,-15.7585715944633,2.8174,6.8794,-2
"8648",1,26,7,-19,-28.8630479387037,13.8174,7.8794,8
"8649",1,18,29,11,-5.14377981361658,-16.1826,-14.1206,0
"8650",1,21,29,8,-9.24307904609578,-13.1826,-14.1206,3
"8651",1,17,18,1,-10.6959319513343,-6.1826,-3.1206,-1
"8652",1,23,28,5,-12.3990153968406,-10.1826,-13.1206,5
"8653",1,23,17,-6,-19.257497533115,0.8174,-2.1206,5
"8654",1,28,14,-14,-27.6029767040852,8.8174,0.8794,10
"8655",1,21,5,-16,-23.761331891303,10.8174,9.8794,3
"8656",1,20,1,-19,-24.834569516105,13.8174,13.8794,2
"8657",1,20,2,-18,-24.0464307209371,12.8174,12.8794,2
"8658",1,22,29,7,-10.6471898911096,-12.1826,-14.1206,4
"8659",1,15,20,5,-7.06727830957922,-10.1826,-5.1206,-3
"8660",1,18,16,-2,-13.5571611781561,-3.1826,-1.1206,0
"8661",1,16,0,-16,-20.2939239492053,10.8174,14.8794,-2
"8662",1,18,27,9,-6.69491192838391,-14.1826,-12.1206,0
"8663",1,20,16,-4,-15.839026586169,-1.1826,-1.1206,2
"8664",1,21,3,-18,-25.3043195218367,12.8174,11.8794,3
"8665",1,19,22,3,-10.7577898752213,-8.1826,-7.1206,1
"8666",1,22,12,-10,-20.9418042151233,4.8174,2.8794,4
"8667",1,17,11,-6,-15.1924039754865,0.8174,3.8794,-1
"8668",1,23,3,-20,-27.483315096463,14.8174,11.8794,5
"8669",1,21,12,-9,-19.6806099821943,3.8174,2.8794,3
"8670",1,21,0,-21,-26.9472956149503,15.8174,14.8794,3
"8671",1,14,3,-11,-15.9274109241134,5.8174,11.8794,-4
"8672",1,19,26,7,-8.80077292633282,-12.1826,-11.1206,1
"8673",1,18,28,10,-5.69624606557205,-15.1826,-13.1206,0
"8674",1,18,21,3,-10.5263449151716,-8.1826,-6.1206,0
"8675",1,27,1,-26,-34.1268700424823,20.8174,13.8794,9
"8676",1,27,1,-26,-33.9041049756854,20.8174,13.8794,9
"8677",1,23,7,-16,-25.1117787218592,10.8174,7.8794,5
"8678",1,23,12,-11,-22.2132349828499,5.8174,2.8794,5
"8679",1,26,30,4,-15.0841278706568,-9.1826,-15.1206,8
"8680",1,14,24,10,-3.30978294178211,-15.1826,-9.1206,-4
"8681",1,22,4,-18,-25.9661840667992,12.8174,10.8794,4
"8682",1,29,13,-16,-29.3131327831308,10.8174,1.8794,11
"8683",1,23,5,-18,-26.1940749982834,12.8174,9.8794,5
"8684",1,21,3,-18,-24.770162032796,12.8174,11.8794,3
"8685",1,19,28,9,-7.31966297154195,-14.1826,-13.1206,1
"8686",1,20,26,6,-9.92886823360231,-11.1826,-11.1206,2
"8687",1,27,14,-13,-26.1664480056101,7.8174,0.8794,9
"8688",1,16,29,13,-2.78668375026549,-18.1826,-14.1206,-2
"8689",1,20,4,-16,-23.2695824409631,10.8174,10.8794,2
"8690",1,15,9,-6,-13.7220043321295,0.8174,5.8794,-3
"8691",1,21,23,2,-12.9665034291195,-7.1826,-8.1206,3
"8692",1,17,7,-10,-17.2728277891607,4.8174,7.8794,-1
"8693",1,18,1,-17,-22.3616431873734,11.8174,13.8794,0
"8694",1,16,7,-9,-16.091061278953,3.8174,7.8794,-2
"8695",1,19,25,6,-9.06619403637136,-11.1826,-10.1206,1
"8696",1,23,18,-5,-18.8480229808992,-0.1826,-3.1206,5
"8697",1,19,4,-15,-21.6382895085739,9.8174,10.8794,1
"8698",1,9,11,2,-4.73726738910011,-7.1826,3.8794,-9
"8699",1,17,1,-16,-21.0803616203569,10.8174,13.8794,-1
"8700",1,18,23,5,-9.18441302376773,-10.1826,-8.1206,0
"8701",1,12,5,-7,-12.1281054672905,1.8174,9.8794,-6
"8702",1,16,28,12,-3.72329871997743,-17.1826,-13.1206,-2
"8703",1,20,24,4,-11.1115030337521,-9.1826,-9.1206,2
"8704",1,23,8,-15,-24.6613178891291,9.8174,6.8794,5
"8705",1,23,24,1,-14.9586075800946,-6.1826,-9.1206,5
"8706",1,22,11,-11,-21.4003419622044,5.8174,3.8794,4
"8707",1,12,6,-6,-11.7421100859231,0.8174,8.8794,-6
"8708",1,18,2,-16,-21.6047529140724,10.8174,12.8794,0
"8709",1,18,20,2,-10.757247887231,-7.1826,-5.1206,0
"8710",1,23,9,-14,-24.1467074759168,8.8174,5.8794,5
"8711",1,20,20,0,-13.4639599683408,-5.1826,-5.1206,2
"8712",1,22,27,5,-11.8607578576834,-10.1826,-12.1206,4
"8713",1,16,26,10,-4.88995049745799,-15.1826,-11.1206,-2
"8714",1,22,26,4,-12.3479027991529,-9.1826,-11.1206,4
"8715",1,23,25,2,-14.4423319775459,-7.1826,-10.1206,5
"8716",1,20,5,-15,-22.2344642873675,9.8174,9.8794,2
"8717",1,23,16,-7,-20.0542956234602,1.8174,-1.1206,5
"8718",1,13,11,-2,-9.48763578014902,-3.1826,3.8794,-5
"8719",1,21,12,-9,-19.4055309994842,3.8174,2.8794,3
"8720",1,15,6,-9,-15.51989781389,3.8174,8.8794,-3
"8721",1,16,22,6,-7.17108360254098,-11.1826,-7.1206,-2
"8722",1,26,0,-26,-33.4615476570422,20.8174,14.8794,8
"8723",1,26,18,-8,-22.4600679329666,2.8174,-3.1206,8
"8724",1,18,19,1,-11.2966455858745,-6.1826,-4.1206,0
"8725",1,27,25,-2,-19.4468777463488,-3.1826,-10.1206,9
"8726",1,27,29,2,-17.1527159789409,-7.1826,-14.1206,9
"8727",1,25,25,0,-16.6835361475182,-5.1826,-10.1206,7
"8728",1,20,3,-17,-23.52373225667,11.8174,11.8794,2
"8729",1,25,6,-19,-28.494464089851,13.8174,8.8794,7
"8730",1,20,9,-11,-19.8653543447156,5.8174,5.8794,2
"8731",1,25,9,-16,-26.544823874511,10.8174,5.8794,7
"8732",1,19,15,-4,-15.384233252995,-1.1826,-0.1206,1
"8733",1,18,24,6,-8.57532280011483,-11.1826,-9.1206,0
"8734",1,18,24,6,-8.5050412514973,-11.1826,-9.1206,0
"8735",1,20,15,-5,-16.50782455983,-0.1826,-0.1206,2
"8736",1,26,11,-15,-26.467649235132,9.8174,3.8794,8
"8737",1,25,25,0,-16.8421594776838,-5.1826,-10.1206,7
"8738",1,27,13,-14,-26.8529762961438,8.8174,1.8794,9
"8739",1,14,25,11,-2.8493994932117,-16.1826,-10.1206,-4
"8740",1,21,29,8,-9.48696115737681,-13.1826,-14.1206,3
"8741",1,15,29,14,-1.71107871742932,-19.1826,-14.1206,-3
"8742",1,19,29,10,-6.84965833119073,-15.1826,-14.1206,1
"8743",1,14,15,1,-8.76119769867129,-6.1826,-0.1206,-4
"8744",1,19,25,6,-9.08222306719565,-11.1826,-10.1206,1
"8745",1,16,12,-4,-12.8649765953733,-1.1826,2.8794,-2
"8746",1,17,27,10,-5.45584658681732,-15.1826,-12.1206,-1
"8747",1,16,9,-7,-14.8754558370598,1.8174,5.8794,-2
"8748",1,25,25,0,-17.0980862747178,-5.1826,-10.1206,7
"8749",1,12,28,16,1.56354460535076,-21.1826,-13.1206,-6
"8750",1,25,29,4,-14.679129154598,-9.1826,-14.1206,7
"8751",1,29,19,-10,-25.6537626239335,4.8174,-4.1206,11
"8752",1,16,5,-11,-17.7160191046632,5.8174,9.8794,-2
"8753",1,24,23,-1,-16.8712395750587,-4.1826,-8.1206,6
"8754",1,22,10,-12,-22.1000904808815,6.8174,4.8794,4
"8755",1,16,2,-14,-19.3827236268185,8.8174,12.8794,-2
"8756",1,19,25,6,-9.14919627677781,-11.1826,-10.1206,1
"8757",1,21,28,7,-10.0398278297991,-12.1826,-13.1206,3
"8758",1,17,27,10,-5.17341942597673,-15.1826,-12.1206,-1
"8759",1,26,8,-18,-28.4305587359017,12.8174,6.8794,8
"8760",1,18,14,-4,-14.4979892401146,-1.1826,0.8794,0
"8761",1,28,23,-5,-21.8894983506653,-0.1826,-8.1206,10
"8762",1,17,27,10,-5.57584365123229,-15.1826,-12.1206,-1
"8763",1,23,15,-8,-20.5117709648763,2.8174,-0.1206,5
"8764",1,21,15,-6,-17.7117820883441,0.8174,-0.1206,3
"8765",1,18,2,-16,-21.5116077043889,10.8174,12.8794,0
"8766",1,15,18,3,-8.19834414421656,-8.1826,-3.1206,-3
"8767",1,25,25,0,-16.789645175946,-5.1826,-10.1206,7
"8768",1,19,28,9,-7.51109910404101,-14.1826,-13.1206,1
"8769",1,26,17,-9,-23.2119308459446,3.8174,-2.1206,8
"8770",1,24,15,-9,-21.5459403501565,3.8174,-0.1206,6
"8771",1,25,14,-11,-23.6798048730702,5.8174,0.8794,7
"8772",1,19,18,-1,-13.3643551009729,-4.1826,-3.1206,1
"8773",1,19,2,-17,-22.9372368770838,11.8174,12.8794,1
"8774",1,32,19,-13,-29.4723958245753,7.8174,-4.1206,14
"8775",1,11,12,1,-6.81416871077623,-6.1826,2.8794,-7
"8776",1,19,24,5,-9.69751463594781,-10.1826,-9.1206,1
"8777",1,25,13,-12,-24.2642691824873,6.8174,1.8794,7
"8778",1,19,23,4,-10.5918593312974,-9.1826,-8.1206,1
"8779",1,25,22,-3,-18.4388637392961,-2.1826,-7.1206,7
"8780",1,15,11,-4,-12.2988795061182,-1.1826,3.8794,-3
"8781",1,18,18,0,-11.9632971728725,-5.1826,-3.1206,0
"8782",1,20,26,6,-9.88666699947967,-11.1826,-11.1206,2
"8783",1,29,2,-27,-36.0187754157692,21.8174,12.8794,11
"8784",1,19,27,8,-7.8711677575219,-13.1826,-12.1206,1
"8785",1,14,29,15,-0.601838369413313,-20.1826,-14.1206,-4
"8786",1,20,5,-15,-22.3330264590306,9.8174,9.8794,2
"8787",1,31,21,-10,-27.0723946533604,4.8174,-6.1206,13
"8788",1,21,0,-21,-27.1852816113044,15.8174,14.8794,3
"8789",1,25,28,3,-14.9354103470553,-8.1826,-13.1206,7
"8790",1,15,19,4,-7.49846268981235,-9.1826,-4.1206,-3
"8791",1,13,2,-11,-15.1769605175407,5.8174,12.8794,-5
"8792",1,29,13,-16,-29.3605422050545,10.8174,1.8794,11
"8793",1,17,2,-15,-20.3359850832674,9.8174,12.8794,-1
"8794",1,25,3,-22,-30.3798750829189,16.8174,11.8794,7
"8795",1,27,9,-18,-29.4141352129374,12.8174,5.8794,9
"8796",1,16,15,-1,-11.1516192482996,-4.1826,-0.1206,-2
"8797",1,23,23,0,-15.4846377379211,-5.1826,-8.1206,5
"8798",1,14,8,-6,-12.9967299961994,0.8174,6.8794,-4
"8799",1,22,21,-1,-15.4248166728736,-4.1826,-6.1206,4
"8800",1,21,20,-1,-14.8936384831595,-4.1826,-5.1206,3
"8801",1,14,16,2,-7.95966265877295,-7.1826,-1.1206,-4
"8802",1,19,29,10,-6.5054459387855,-15.1826,-14.1206,1
"8803",1,21,3,-18,-24.7697152766167,12.8174,11.8794,3
"8804",1,24,26,2,-15.1010043269195,-7.1826,-11.1206,6
"8805",1,17,1,-16,-21.0017571426266,10.8174,13.8794,-1
"8806",1,20,9,-11,-20.0928550331276,5.8174,5.8794,2
"8807",1,14,7,-7,-13.5012164663955,1.8174,7.8794,-4
"8808",1,18,1,-17,-22.3722625425353,11.8174,13.8794,0
"8809",1,22,30,8,-10.1833437507023,-13.1826,-15.1206,4
"8810",1,21,23,2,-13.0117797113354,-7.1826,-8.1206,3
"8811",1,19,23,4,-10.231196936208,-9.1826,-8.1206,1
"8812",1,18,5,-13,-19.8712963243618,7.8174,9.8794,0
"8813",1,22,26,4,-12.622349342939,-9.1826,-11.1206,4
"8814",1,18,28,10,-6.05507980313459,-15.1826,-13.1206,0
"8815",1,20,15,-5,-16.6722121243545,-0.1826,-0.1206,2
"8816",1,21,28,7,-9.98280752690441,-12.1826,-13.1206,3
"8817",1,25,7,-18,-27.891953225873,12.8174,7.8794,7
"8818",1,16,15,-1,-11.4340328137713,-4.1826,-0.1206,-2
"8819",1,23,12,-11,-22.1033127875798,5.8174,2.8794,5
"8820",1,24,23,-1,-16.843675170215,-4.1826,-8.1206,6
"8821",1,15,10,-5,-12.6493063306408,-0.1826,4.8794,-3
"8822",1,21,25,4,-11.8828237438014,-9.1826,-10.1206,3
"8823",1,23,24,1,-15.0013647989627,-6.1826,-9.1206,5
"8824",1,21,27,6,-10.6981041747305,-11.1826,-12.1206,3
"8825",1,19,2,-17,-23.1770927179855,11.8174,12.8794,1
"8826",1,19,6,-13,-20.8173288915416,7.8174,8.8794,1
"8827",1,26,13,-13,-25.1802025645433,7.8174,1.8794,8
"8828",1,27,23,-4,-21.089249139774,-1.1826,-8.1206,9
"8829",1,15,11,-4,-12.4995629885572,-1.1826,3.8794,-3
"8830",1,14,30,16,0.181183832936443,-21.1826,-15.1206,-4
"8831",1,20,29,9,-7.83815616356861,-14.1826,-14.1206,2
"8832",1,13,21,8,-3.93783531498594,-13.1826,-6.1206,-5
"8833",1,29,23,-6,-23.2554020784137,0.8174,-8.1206,11
"8834",1,22,22,0,-14.8399019203316,-5.1826,-7.1206,4
"8835",1,16,30,14,-2.33849422985264,-19.1826,-15.1206,-2
"8836",1,19,17,-2,-14.1385824676373,-3.1826,-2.1206,1
"8837",1,18,19,1,-11.5515730313966,-6.1826,-4.1206,0
"8838",1,21,19,-2,-15.1931390326294,-3.1826,-4.1206,3
"8839",1,20,2,-18,-24.1546409361954,12.8174,12.8794,2
"8840",1,23,27,4,-13.4741195215195,-9.1826,-12.1206,5
"8841",1,18,25,7,-7.82513192721733,-12.1826,-10.1206,0
"8842",1,26,8,-18,-28.5010871891719,12.8174,6.8794,8
"8843",1,27,15,-12,-25.4163600990935,6.8174,-0.1206,9
"8844",1,22,2,-20,-26.8402280182546,14.8174,12.8794,4
"8845",1,23,15,-8,-20.5402882353363,2.8174,-0.1206,5
"8846",1,15,6,-9,-15.5157134318424,3.8174,8.8794,-3
"8847",1,21,3,-18,-25.0737711349058,12.8174,11.8794,3
"8848",1,20,9,-11,-20.2278281609507,5.8174,5.8794,2
"8849",1,24,16,-8,-20.966926667811,2.8174,-1.1206,6
"8850",1,29,0,-29,-37.4420504007724,23.8174,14.8794,11
"8851",1,17,21,4,-8.85988804823246,-9.1826,-6.1206,-1
"8852",1,17,12,-5,-14.5319530113591,-0.1826,2.8794,-1
"8853",1,18,8,-10,-18.1181642479395,4.8174,6.8794,0
"8854",1,15,21,6,-6.35175560514287,-11.1826,-6.1206,-3
"8855",1,15,26,11,-3.41016733622702,-16.1826,-11.1206,-3
"8856",1,15,10,-5,-12.7962273403767,-0.1826,4.8794,-3
"8857",1,17,14,-3,-13.1347727892971,-2.1826,0.8794,-1
"8858",1,21,3,-18,-24.9618934853709,12.8174,11.8794,3
"8859",1,16,27,11,-4.08176208794326,-16.1826,-12.1206,-2
"8860",1,21,20,-1,-14.9315000261597,-4.1826,-5.1206,3
"8861",1,15,27,12,-2.86104281934163,-17.1826,-12.1206,-3
"8862",1,23,27,4,-13.0261630429483,-9.1826,-12.1206,5
"8863",1,18,16,-2,-13.4600836287971,-3.1826,-1.1206,0
"8864",1,15,9,-6,-13.5534696105389,0.8174,5.8794,-3
"8865",1,24,22,-2,-17.3072698958571,-3.1826,-7.1206,6
"8866",1,13,28,15,0.267174252788525,-20.1826,-13.1206,-5
"8867",1,19,22,3,-11.066160502116,-8.1826,-7.1206,1
"8868",1,16,1,-15,-19.837386896531,9.8174,13.8794,-2
"8869",1,16,2,-14,-19.1227909559976,8.8174,12.8794,-2
"8870",1,15,25,10,-4.16191933353253,-15.1826,-10.1206,-3
"8871",1,20,27,7,-9.2181888624207,-12.1826,-12.1206,2
"8872",1,24,19,-5,-19.3357660167241,-0.1826,-4.1206,6
"8873",1,30,18,-12,-27.7927473219986,6.8174,-3.1206,12
"8874",1,18,19,1,-11.6022538591414,-6.1826,-4.1206,0
"8875",1,17,0,-17,-21.5376935047653,11.8174,14.8794,-1
"8876",1,25,25,0,-17.00412790458,-5.1826,-10.1206,7
"8877",1,17,2,-15,-20.5519165031096,9.8174,12.8794,-1
"8878",1,20,11,-9,-18.7786919442568,3.8174,3.8794,2
"8879",1,25,7,-18,-27.884775622544,12.8174,7.8794,7
"8880",1,24,17,-7,-20.6260445956319,1.8174,-2.1206,6
"8881",1,20,0,-20,-25.5135774792289,14.8174,14.8794,2
"8882",1,14,17,3,-7.51128540135141,-8.1826,-2.1206,-4
"8883",1,28,17,-11,-25.4395184338528,5.8174,-2.1206,10
"8884",1,26,6,-20,-29.4762913756097,14.8174,8.8794,8
"8885",1,15,5,-10,-16.0332921968304,4.8174,9.8794,-3
"8886",1,29,1,-28,-36.6038402254738,22.8174,13.8794,11
"8887",1,21,14,-7,-18.2221322919885,1.8174,0.8794,3
"8888",1,26,9,-17,-27.8392193288275,11.8174,5.8794,8
"8889",1,15,30,15,-0.798868571309207,-20.1826,-15.1206,-3
"8890",1,27,11,-16,-27.6360384787416,10.8174,3.8794,9
"8891",1,16,8,-8,-15.5210647922547,2.8174,6.8794,-2
"8892",1,19,20,1,-12.0975538007484,-6.1826,-5.1206,1
"8893",1,19,1,-18,-23.5373575649023,12.8174,13.8794,1
"8894",1,17,1,-16,-20.9647891671253,10.8174,13.8794,-1
"8895",1,26,10,-16,-27.3908571986032,10.8174,4.8794,8
"8896",1,20,4,-16,-23.1410146263146,10.8174,10.8794,2
"8897",1,18,19,1,-11.4877984562234,-6.1826,-4.1206,0
"8898",1,16,23,7,-6.56563378927753,-12.1826,-8.1206,-2
"8899",1,22,10,-12,-21.9993639114272,6.8174,4.8794,4
"8900",1,12,16,4,-5.77674812781186,-9.1826,-1.1206,-6
"8901",1,21,16,-5,-17.1484610565409,-0.1826,-1.1206,3
"8902",1,19,2,-17,-23.0944752700053,11.8174,12.8794,1
"8903",1,17,26,9,-5.83592324577041,-14.1826,-11.1206,-1
"8904",1,14,6,-8,-14.2080071229403,2.8174,8.8794,-4
"8905",1,21,4,-17,-24.301249702011,11.8174,10.8794,3
"8906",1,17,21,4,-8.86980238715968,-9.1826,-6.1206,-1
"8907",1,20,7,-13,-21.3713842412038,7.8174,7.8794,2
"8908",1,13,1,-12,-15.8633547496741,6.8174,13.8794,-5
"8909",1,30,3,-27,-36.9243094291884,21.8174,11.8794,12
"8910",1,23,15,-8,-20.5100323803503,2.8174,-0.1206,5
"8911",1,23,23,0,-15.4151507885026,-5.1826,-8.1206,5
"8912",1,16,14,-2,-11.91675822034,-3.1826,0.8794,-2
"8913",1,24,17,-7,-20.5683375041377,1.8174,-2.1206,6
"8914",1,15,13,-2,-11.215217449038,-3.1826,1.8794,-3
"8915",1,17,24,7,-7.27718813408129,-12.1826,-9.1206,-1
"8916",1,21,3,-18,-25.1649613636606,12.8174,11.8794,3
"8917",1,16,13,-3,-12.7926484193742,-2.1826,1.8794,-2
"8918",1,13,19,6,-4.85313430459573,-11.1826,-4.1206,-5
"8919",1,26,17,-9,-23.0701184857804,3.8174,-2.1206,8
"8920",1,5,12,7,1.21373503826272,-12.1826,2.8794,-13
"8921",1,24,3,-21,-28.8589562647876,15.8174,11.8794,6
"8922",1,22,2,-20,-26.8616032141438,14.8174,12.8794,4
"8923",1,22,15,-7,-19.3053565552358,1.8174,-0.1206,4
"8924",1,24,17,-7,-20.5720226961226,1.8174,-2.1206,6
"8925",1,25,10,-15,-25.9098006055058,9.8174,4.8794,7
"8926",1,27,11,-16,-27.7595892851223,10.8174,3.8794,9
"8927",1,18,1,-17,-22.3360817269273,11.8174,13.8794,0
"8928",1,23,16,-7,-19.7995950234936,1.8174,-1.1206,5
"8929",1,21,23,2,-13.0494269339309,-7.1826,-8.1206,3
"8930",1,24,0,-24,-30.8308339769488,18.8174,14.8794,6
"8931",1,15,2,-13,-18.0620891360108,7.8174,12.8794,-3
"8932",1,22,26,4,-12.4260658408037,-9.1826,-11.1206,4
"8933",1,17,11,-6,-15.142407035254,0.8174,3.8794,-1
"8934",1,26,30,4,-15.2802843889884,-9.1826,-15.1206,8
"8935",1,17,15,-2,-12.7192976208548,-3.1826,-0.1206,-1
"8936",1,18,14,-4,-14.3004539398754,-1.1826,0.8794,0
"8937",1,16,17,1,-9.87579807414391,-6.1826,-2.1206,-2
"8938",1,18,24,6,-8.59968023702057,-11.1826,-9.1206,0
"8939",1,10,1,-9,-11.9808310198653,3.8174,13.8794,-8
"8940",1,17,18,1,-10.7659292810621,-6.1826,-3.1206,-1
"8941",1,14,12,-2,-10.5724783796625,-3.1826,2.8794,-4
"8942",1,19,3,-16,-22.4158928203896,10.8174,11.8794,1
"8943",1,6,12,6,-0.246766157690655,-11.1826,2.8794,-12
"8944",1,19,6,-13,-20.438000800008,7.8174,8.8794,1
"8945",1,19,9,-10,-18.5293794154047,4.8174,5.8794,1
"8946",1,17,16,-1,-12.0275801848975,-4.1826,-1.1206,-1
"8947",1,18,18,0,-11.8156367578642,-5.1826,-3.1206,0
"8948",1,23,16,-7,-19.6908927993852,1.8174,-1.1206,5
"8949",1,19,20,1,-11.9993393122861,-6.1826,-5.1206,1
"8950",1,19,25,6,-9.15653608787266,-11.1826,-10.1206,1
"8951",1,30,30,0,-20.4842688969201,-5.1826,-15.1206,12
"8952",1,20,22,2,-12.2242510255444,-7.1826,-7.1206,2
"8953",1,23,29,6,-12.0233720777688,-11.1826,-14.1206,5
"8954",1,13,16,3,-6.65661512568752,-8.1826,-1.1206,-5
"8955",1,29,19,-10,-25.8020348603094,4.8174,-4.1206,11
"8956",1,18,17,-1,-12.7631054586045,-4.1826,-2.1206,0
"8957",1,15,7,-8,-15.0280918682168,2.8174,7.8794,-3
"8958",1,14,1,-13,-17.0177302357484,7.8174,13.8794,-4
"8959",1,17,23,6,-7.96414720276119,-11.1826,-8.1206,-1
"8960",1,17,19,2,-10.1875966427466,-7.1826,-4.1206,-1
"8961",1,17,4,-13,-19.0096198791425,7.8174,10.8794,-1
"8962",1,22,29,7,-10.8546242628834,-12.1826,-14.1206,4
"8963",1,15,9,-6,-13.5180003015092,0.8174,5.8794,-3
"8964",1,22,29,7,-10.741737404359,-12.1826,-14.1206,4
"8965",1,25,29,4,-14.9322426812622,-9.1826,-14.1206,7
"8966",1,21,7,-14,-22.4937660048111,8.8174,7.8794,3
"8967",1,25,2,-23,-30.704726420618,17.8174,12.8794,7
"8968",1,15,1,-14,-18.4420432077768,8.8174,13.8794,-3
"8969",1,16,1,-15,-19.7531552738099,9.8174,13.8794,-2
"8970",1,18,11,-7,-16.2993981748296,1.8174,3.8794,0
"8971",1,18,9,-9,-17.4702851619413,3.8174,5.8794,0
"8972",1,21,29,8,-9.28774545912582,-13.1826,-14.1206,3
"8973",1,23,14,-9,-20.7751310882919,3.8174,0.8794,5
"8974",1,18,8,-10,-18.1248681557797,4.8174,6.8794,0
"8975",1,21,19,-2,-15.3030703673736,-3.1826,-4.1206,3
"8976",1,22,17,-5,-17.8941592711993,-0.1826,-2.1206,4
"8977",1,18,12,-6,-15.9298293157431,0.8174,2.8794,0
"8978",1,16,11,-5,-13.9119375582174,-0.1826,3.8794,-2
"8979",1,18,2,-16,-21.7732301874728,10.8174,12.8794,0
"8980",1,27,4,-23,-32.2005289995301,17.8174,10.8794,9
"8981",1,19,28,9,-7.31559357853898,-14.1826,-13.1206,1
"8982",1,21,4,-17,-24.4973022292802,11.8174,10.8794,3
"8983",1,23,10,-13,-23.204044517408,7.8174,4.8794,5
"8984",1,21,7,-14,-22.5237928187246,8.8174,7.8794,3
"8985",1,17,8,-9,-16.6083669971387,3.8174,6.8794,-1
"8986",1,17,20,3,-9.46146390831636,-8.1826,-5.1206,-1
"8987",1,14,17,3,-7.61185023821706,-8.1826,-2.1206,-4
"8988",1,19,28,9,-7.30854955684177,-14.1826,-13.1206,1
"8989",1,25,12,-13,-24.8515337443239,7.8174,2.8794,7
"8990",1,16,1,-15,-19.781782621738,9.8174,13.8794,-2
"8991",1,31,6,-25,-36.2066914274363,19.8174,8.8794,13
"8992",1,20,21,1,-12.8905064254339,-6.1826,-6.1206,2
"8993",1,20,7,-13,-21.4330838387715,7.8174,7.8794,2
"8994",1,21,6,-15,-23.1730429020706,9.8174,8.8794,3
"8995",1,21,25,4,-11.7236709965712,-9.1826,-10.1206,3
"8996",1,23,20,-3,-17.2707274618801,-2.1826,-5.1206,5
"8997",1,24,20,-4,-18.5323976515365,-1.1826,-5.1206,6
"8998",1,15,23,8,-5.33413880945972,-13.1826,-8.1206,-3
"8999",1,15,28,13,-2.38262130895181,-18.1826,-13.1206,-3
"9000",1,25,27,2,-15.885288552929,-7.1826,-12.1206,7
"9001",1,17,4,-13,-19.3474560984415,7.8174,10.8794,-1
"9002",1,23,7,-16,-25.3153500181627,10.8174,7.8794,5
"9003",1,18,6,-12,-19.2850399892338,6.8174,8.8794,0
"9004",1,14,20,6,-5.71000520632742,-11.1826,-5.1206,-4
"9005",1,28,23,-5,-22.2050011986218,-0.1826,-8.1206,10
"9006",1,22,2,-20,-27.2043406461074,14.8174,12.8794,4
"9007",1,20,30,10,-7.37161008409172,-15.1826,-15.1206,2
"9008",1,12,2,-10,-13.9596414883356,4.8174,12.8794,-6
"9009",1,23,5,-18,-26.2552319782306,12.8174,9.8794,5
"9010",1,25,1,-24,-31.1123187947007,18.8174,13.8794,7
"9011",1,17,22,5,-8.54736908939004,-10.1826,-7.1206,-1
"9012",1,18,14,-4,-14.4771592957435,-1.1826,0.8794,0
"9013",1,25,14,-11,-23.7916256495958,5.8174,0.8794,7
"9014",1,20,8,-12,-20.7523721040208,6.8174,6.8794,2
"9015",1,27,30,3,-16.6102115802101,-8.1826,-15.1206,9
"9016",1,15,9,-6,-13.4621250867763,0.8174,5.8794,-3
"9017",1,14,4,-10,-15.4122621935887,4.8174,10.8794,-4
"9018",1,28,26,-2,-20.3228587431253,-3.1826,-11.1206,10
"9019",1,20,1,-19,-25.0089931659668,13.8174,13.8794,2
"9020",1,14,0,-14,-17.516054797896,8.8174,14.8794,-4
"9021",1,22,1,-21,-27.4994468290506,15.8174,13.8794,4
"9022",1,19,5,-14,-21.1813877996111,8.8174,9.8794,1
"9023",1,18,15,-3,-13.9256869963305,-2.1826,-0.1206,0
"9024",1,13,3,-10,-14.7891430128412,4.8174,11.8794,-5
"9025",1,18,18,0,-12.1638091726725,-5.1826,-3.1206,0
"9026",1,18,3,-15,-21.0130147555434,9.8174,11.8794,0
"9027",1,24,22,-2,-17.543066080484,-3.1826,-7.1206,6
"9028",1,23,10,-13,-23.1982221055202,7.8174,4.8794,5
"9029",1,26,6,-20,-29.5926828582213,14.8174,8.8794,8
"9030",1,17,29,12,-4.15681175677125,-17.1826,-14.1206,-1
"9031",1,17,3,-14,-19.4565657200713,8.8174,11.8794,-1
"9032",1,23,12,-11,-22.2043899786952,5.8174,2.8794,5
"9033",1,22,11,-11,-21.6873459717453,5.8174,3.8794,4
"9034",1,17,7,-10,-17.6752193329898,4.8174,7.8794,-1
"9035",1,23,15,-8,-20.5652432173537,2.8174,-0.1206,5
"9036",1,29,5,-24,-33.9948359207848,18.8174,9.8794,11
"9037",1,22,23,1,-14.5529674132877,-6.1826,-8.1206,4
"9038",1,26,27,1,-17.1800427368433,-6.1826,-12.1206,8
"9039",1,16,24,8,-6.12461819871248,-13.1826,-9.1206,-2
"9040",1,18,4,-14,-20.5548548208596,8.8174,10.8794,0
"9041",1,21,4,-17,-24.5001805209394,11.8174,10.8794,3
"9042",1,16,25,9,-4.96062208376557,-14.1826,-10.1206,-2
"9043",1,19,15,-4,-15.1023266206436,-1.1826,-0.1206,1
"9044",1,15,11,-4,-12.5332254406546,-1.1826,3.8794,-3
"9045",1,26,13,-13,-25.504949537689,7.8174,1.8794,8
"9046",1,19,30,11,-6.07511121989326,-16.1826,-15.1206,1
"9047",1,15,17,2,-8.87259967039968,-7.1826,-2.1206,-3
"9048",1,21,14,-7,-18.6320218380218,1.8174,0.8794,3
"9049",1,20,20,0,-13.6395700309548,-5.1826,-5.1206,2
"9050",1,17,11,-6,-15.0615164700996,0.8174,3.8794,-1
"9051",1,18,15,-3,-13.8963986245769,-2.1826,-0.1206,0
"9052",1,20,22,2,-12.368981983707,-7.1826,-7.1206,2
"9053",1,14,16,2,-8.03036337183766,-7.1826,-1.1206,-4
"9054",1,15,24,9,-4.72939998107946,-14.1826,-9.1206,-3
"9055",1,23,15,-8,-20.2491137069726,2.8174,-0.1206,5
"9056",1,20,25,5,-10.3253198748816,-10.1826,-10.1206,2
"9057",1,17,11,-6,-14.8972119023321,0.8174,3.8794,-1
"9058",1,25,26,1,-16.2926348106119,-6.1826,-11.1206,7
"9059",1,20,24,4,-11.3267614376521,-9.1826,-9.1206,2
"9060",1,14,15,1,-8.76829642602406,-6.1826,-0.1206,-4
"9061",1,11,1,-10,-13.3301242147101,4.8174,13.8794,-7
"9062",1,24,17,-7,-20.2164809552589,1.8174,-2.1206,6
"9063",1,26,9,-17,-28.2914148723396,11.8174,5.8794,8
"9064",1,20,8,-12,-20.5766546738401,6.8174,6.8794,2
"9065",1,23,29,6,-12.0447535933383,-11.1826,-14.1206,5
"9066",1,14,19,5,-6.37353169547497,-10.1826,-4.1206,-4
"9067",1,24,10,-14,-24.7827833998372,8.8174,4.8794,6
"9068",1,22,23,1,-14.3729079552662,-6.1826,-8.1206,4
"9069",1,23,5,-18,-26.5966637914388,12.8174,9.8794,5
"9070",1,20,5,-15,-22.4875236836196,9.8174,9.8794,2
"9071",1,15,28,13,-2.23745693481894,-18.1826,-13.1206,-3
"9072",1,18,10,-8,-17.1265945051485,2.8174,4.8794,0
"9073",1,11,22,11,-0.812571365236557,-16.1826,-7.1206,-7
"9074",1,32,3,-29,-39.1932226552823,23.8174,11.8794,14
"9075",1,19,6,-13,-20.6801386336814,7.8174,8.8794,1
"9076",1,23,6,-17,-25.8238066968475,11.8174,8.8794,5
"9077",1,20,18,-2,-15.0486659098582,-3.1826,-3.1206,2
"9078",1,25,0,-25,-31.7341209341572,19.8174,14.8794,7
"9079",1,24,5,-19,-27.7923580931322,13.8174,9.8794,6
"9080",1,21,10,-11,-20.8497840783652,5.8174,4.8794,3
"9081",1,26,9,-17,-27.729548223566,11.8174,5.8794,8
"9082",1,18,20,2,-10.9005117446526,-7.1826,-5.1206,0
"9083",1,20,30,10,-7.63017151263488,-15.1826,-15.1206,2
"9084",1,17,15,-2,-12.7090744066769,-3.1826,-0.1206,-1
"9085",1,20,14,-6,-17.191136471089,0.8174,0.8794,2
"9086",1,21,19,-2,-15.1422366900277,-3.1826,-4.1206,3
"9087",1,26,24,-2,-18.7246731874592,-3.1826,-9.1206,8
"9088",1,16,1,-15,-19.7527013649084,9.8174,13.8794,-2
"9089",1,19,1,-18,-23.5666292347133,12.8174,13.8794,1
"9090",1,29,23,-6,-23.6026624008513,0.8174,-8.1206,11
"9091",1,21,26,5,-11.3295219406191,-10.1826,-11.1206,3
"9092",1,18,26,8,-7.39075629678684,-13.1826,-11.1206,0
"9093",1,21,21,0,-14.1254145197739,-5.1826,-6.1206,3
"9094",1,22,19,-3,-16.5062216465653,-2.1826,-4.1206,4
"9095",1,29,1,-28,-36.4930402166347,22.8174,13.8794,11
"9096",1,31,18,-13,-29.0466355524755,7.8174,-3.1206,13
"9097",1,17,24,7,-7.38944042316317,-12.1826,-9.1206,-1
"9098",1,13,18,5,-5.59679485251119,-10.1826,-3.1206,-5
"9099",1,23,18,-5,-18.6158276996275,-0.1826,-3.1206,5
"9100",1,29,13,-16,-29.3798215405515,10.8174,1.8794,11
"9101",1,19,29,10,-6.76785479548531,-15.1826,-14.1206,1
"9102",1,14,13,-1,-10.0058175479532,-4.1826,1.8794,-4
"9103",1,21,27,6,-10.7505046545313,-11.1826,-12.1206,3
"9104",1,19,10,-9,-18.2697296026672,3.8174,4.8794,1
"9105",1,14,12,-2,-10.569279420599,-3.1826,2.8794,-4
"9106",1,20,23,3,-11.5680482967837,-8.1826,-8.1206,2
"9107",1,11,6,-5,-10.202573427018,-0.1826,8.8794,-7
"9108",1,23,24,1,-15.0373389520969,-6.1826,-9.1206,5
"9109",1,23,24,1,-14.946819012709,-6.1826,-9.1206,5
"9110",1,27,20,-7,-22.6027194242446,1.8174,-5.1206,9
"9111",1,20,19,-1,-14.0358203489136,-4.1826,-4.1206,2
"9112",1,17,3,-14,-19.8047856629158,8.8174,11.8794,-1
"9113",1,18,22,4,-9.80877869953804,-9.1826,-7.1206,0
"9114",1,15,12,-3,-11.6472444128556,-2.1826,2.8794,-3
"9115",1,22,0,-22,-27.9903473698413,16.8174,14.8794,4
"9116",1,15,22,7,-5.54395946647925,-12.1826,-7.1206,-3
"9117",1,21,7,-14,-22.6548261607355,8.8174,7.8794,3
"9118",1,19,27,8,-7.85158558240948,-13.1826,-12.1206,1
"9119",1,25,21,-4,-19.299273815858,-1.1826,-6.1206,7
"9120",1,22,9,-13,-22.7047268708357,7.8174,5.8794,4
"9121",1,22,14,-8,-19.8243528800879,2.8174,0.8794,4
"9122",1,17,10,-7,-15.7581592591712,1.8174,4.8794,-1
"9123",1,18,7,-11,-18.6404734861645,5.8174,7.8794,0
"9124",1,23,22,-1,-16.1151792735966,-4.1826,-7.1206,5
"9125",1,23,6,-17,-25.8390249229324,11.8174,8.8794,5
"9126",1,19,28,9,-7.09525158446585,-14.1826,-13.1206,1
"9127",1,23,7,-16,-25.4002940118271,10.8174,7.8794,5
"9128",1,25,15,-10,-23.4092305976012,4.8174,-0.1206,7
"9129",1,12,15,3,-5.82711677989257,-8.1826,-0.1206,-6
"9130",1,21,4,-17,-24.2319986615646,11.8174,10.8794,3
"9131",1,21,27,6,-10.5584411034742,-11.1826,-12.1206,3
"9132",1,24,20,-4,-18.742066653282,-1.1826,-5.1206,6
"9133",1,12,7,-5,-10.8642735236181,-0.1826,7.8794,-6
"9134",1,21,26,5,-11.4061708585593,-10.1826,-11.1206,3
"9135",1,18,25,7,-7.78586568539298,-12.1826,-10.1206,0
"9136",1,24,18,-6,-20.0968396664806,0.8174,-3.1206,6
"9137",1,18,3,-15,-20.9918559838438,9.8174,11.8794,0
"9138",1,26,17,-9,-22.8758045445532,3.8174,-2.1206,8
"9139",1,31,24,-7,-25.3921814248235,1.8174,-9.1206,13
"9140",1,24,25,1,-15.7145476469522,-6.1826,-10.1206,6
"9141",1,20,30,10,-7.60624458680477,-15.1826,-15.1206,2
"9142",1,20,16,-4,-16.0400302516591,-1.1826,-1.1206,2
"9143",1,25,0,-25,-32.0053121950334,19.8174,14.8794,7
"9144",1,25,8,-17,-26.9179631459568,11.8174,6.8794,7
"9145",1,18,27,9,-6.60187826513017,-14.1826,-12.1206,0
"9146",1,21,9,-12,-21.27798503115,6.8174,5.8794,3
"9147",1,18,6,-12,-19.2179394243128,6.8174,8.8794,0
"9148",1,13,16,3,-6.71605986072233,-8.1826,-1.1206,-5
"9149",1,23,18,-5,-18.6462009197246,-0.1826,-3.1206,5
"9150",1,16,11,-5,-13.6689274403536,-0.1826,3.8794,-2
"9151",1,20,5,-15,-22.4940666425014,9.8174,9.8794,2
"9152",1,21,27,6,-10.6106128537066,-11.1826,-12.1206,3
"9153",1,17,28,11,-4.58207929958674,-16.1826,-13.1206,-1
"9154",1,14,18,4,-6.54231412717367,-9.1826,-3.1206,-4
"9155",1,20,23,3,-11.6448178439042,-8.1826,-8.1206,2
"9156",1,17,6,-11,-17.8715662095966,5.8174,8.8794,-1
"9157",1,22,16,-6,-18.4930833038341,0.8174,-1.1206,4
"9158",1,18,10,-8,-16.9824770663909,2.8174,4.8794,0
"9159",1,26,21,-5,-20.474089921437,-0.1826,-6.1206,8
"9160",1,29,4,-25,-34.7237601830993,19.8174,10.8794,11
"9161",1,19,23,4,-10.3151256435732,-9.1826,-8.1206,1
"9162",1,24,9,-15,-25.2586256027517,9.8174,5.8794,6
"9163",1,29,24,-5,-22.7775291877637,-0.1826,-9.1206,11
"9164",1,29,11,-18,-30.6601660800351,12.8174,3.8794,11
"9165",1,20,6,-14,-21.8836792583708,8.8174,8.8794,2
"9166",1,19,3,-16,-22.6921329852754,10.8174,11.8794,1
"9167",1,18,20,2,-10.6287436604173,-7.1826,-5.1206,0
"9168",1,17,20,3,-9.79334703195754,-8.1826,-5.1206,-1
"9169",1,16,23,7,-6.51983139298893,-12.1826,-8.1206,-2
"9170",1,19,24,5,-9.90515982830112,-10.1826,-9.1206,1
"9171",1,14,11,-3,-11.1870053735136,-2.1826,3.8794,-4
"9172",1,24,27,3,-14.9038138612001,-8.1826,-12.1206,6
"9173",1,19,6,-13,-21.0028308308806,7.8174,8.8794,1
"9174",1,14,29,15,-0.00722307068131761,-20.1826,-14.1206,-4
"9175",1,21,1,-20,-26.2857646064268,14.8174,13.8794,3
"9176",1,21,11,-10,-20.4462661041606,4.8174,3.8794,3
"9177",1,17,24,7,-7.18129339705058,-12.1826,-9.1206,-1
"9178",1,21,3,-18,-24.997389835647,12.8174,11.8794,3
"9179",1,20,14,-6,-17.0531456260541,0.8174,0.8794,2
"9180",1,16,11,-5,-13.8797665351795,-0.1826,3.8794,-2
"9181",1,15,18,3,-8.32974170461826,-8.1826,-3.1206,-3
"9182",1,23,0,-23,-29.3834947467584,17.8174,14.8794,5
"9183",1,17,6,-11,-17.882668783436,5.8174,8.8794,-1
"9184",1,25,12,-13,-24.7387854797693,7.8174,2.8794,7
"9185",1,22,18,-4,-17.247623736096,-1.1826,-3.1206,4
"9186",1,12,15,3,-6.07011314883254,-8.1826,-0.1206,-6
"9187",1,21,4,-17,-24.6842200794928,11.8174,10.8794,3
"9188",1,21,21,0,-14.3910184901948,-5.1826,-6.1206,3
"9189",1,21,29,8,-9.22654470692546,-13.1826,-14.1206,3
"9190",1,27,5,-22,-31.6564103235499,16.8174,9.8794,9
"9191",1,17,7,-10,-17.1977075235324,4.8174,7.8794,-1
"9192",1,19,16,-3,-14.5894576827481,-2.1826,-1.1206,1
"9193",1,20,22,2,-12.4132480942634,-7.1826,-7.1206,2
"9194",1,19,24,5,-9.91636765531203,-10.1826,-9.1206,1
"9195",1,19,5,-14,-21.0882659530031,8.8174,9.8794,1
"9196",1,22,24,2,-13.4351219087833,-7.1826,-9.1206,4
"9197",1,22,19,-3,-16.5095714376512,-2.1826,-4.1206,4
"9198",1,19,2,-17,-23.1653940562016,11.8174,12.8794,1
"9199",1,24,7,-17,-26.537810886654,11.8174,7.8794,6
"9200",1,23,21,-2,-17.0166469482541,-3.1826,-6.1206,5
"9201",1,27,9,-18,-28.9987276712843,12.8174,5.8794,9
"9202",1,13,10,-3,-10.1636090542477,-2.1826,4.8794,-5
"9203",1,21,8,-13,-21.7711613226977,7.8174,6.8794,3
"9204",1,23,15,-8,-20.3094087368632,2.8174,-0.1206,5
"9205",1,17,14,-3,-13.3012909024113,-2.1826,0.8794,-1
"9206",1,19,20,1,-12.0316881265678,-6.1826,-5.1206,1
"9207",1,13,29,16,0.828425465576472,-21.1826,-14.1206,-5
"9208",1,17,24,7,-7.39601502682688,-12.1826,-9.1206,-1
"9209",1,22,13,-9,-19.9223615689995,3.8174,1.8794,4
"9210",1,11,22,11,-0.523704358997438,-16.1826,-7.1206,-7
"9211",1,16,22,6,-6.82196997876257,-11.1826,-7.1206,-2
"9212",1,23,21,-2,-16.319488542471,-3.1826,-6.1206,5
"9213",1,16,4,-12,-17.9145974979987,6.8174,10.8794,-2
"9214",1,12,23,11,-1.43867245130393,-16.1826,-8.1206,-6
"9215",1,19,17,-2,-13.8188707516613,-3.1826,-2.1206,1
"9216",1,22,19,-3,-16.5277077149326,-2.1826,-4.1206,4
"9217",1,18,14,-4,-14.5857301778905,-1.1826,0.8794,0
"9218",1,13,1,-12,-15.5482442206897,6.8174,13.8794,-5
"9219",1,22,22,0,-14.9256996882315,-5.1826,-7.1206,4
"9220",1,21,29,8,-9.51769376177454,-13.1826,-14.1206,3
"9221",1,23,14,-9,-20.9452502294452,3.8174,0.8794,5
"9222",1,20,30,10,-7.52388405038501,-15.1826,-15.1206,2
"9223",1,17,29,12,-4.25169428089493,-17.1826,-14.1206,-1
"9224",1,21,13,-8,-18.8742002504085,2.8174,1.8794,3
"9225",1,8,17,9,0.374045067513485,-14.1826,-2.1206,-10
"9226",1,25,7,-18,-27.7166255547678,12.8174,7.8794,7
"9227",1,14,1,-13,-17.1830903477179,7.8174,13.8794,-4
"9228",1,21,14,-7,-18.4604162763487,1.8174,0.8794,3
"9229",1,26,13,-13,-25.5765058757275,7.8174,1.8794,8
"9230",1,16,17,1,-10.0840846692758,-6.1826,-2.1206,-2
"9231",1,19,17,-2,-14.1641880792456,-3.1826,-2.1206,1
"9232",1,16,23,7,-6.60673017265773,-12.1826,-8.1206,-2
"9233",1,23,18,-5,-18.461742367734,-0.1826,-3.1206,5
"9234",1,16,20,4,-8.25998460070015,-9.1826,-5.1206,-2
"9235",1,16,0,-16,-20.0615332550781,10.8174,14.8794,-2
"9236",1,19,28,9,-7.38985290843761,-14.1826,-13.1206,1
"9237",1,27,23,-4,-20.6353897686033,-1.1826,-8.1206,9
"9238",1,24,6,-18,-27.1649788000638,12.8174,8.8794,6
"9239",1,19,29,10,-6.38697808022332,-15.1826,-14.1206,1
"9240",1,20,16,-4,-15.944711396139,-1.1826,-1.1206,2
"9241",1,21,9,-12,-21.5420228627506,6.8174,5.8794,3
"9242",1,19,12,-7,-16.9174700908232,1.8174,2.8794,1
"9243",1,14,30,16,0.294886211523026,-21.1826,-15.1206,-4
"9244",1,18,17,-1,-12.8185037891834,-4.1826,-2.1206,0
"9245",1,18,15,-3,-13.9081021190151,-2.1826,-0.1206,0
"9246",1,23,26,3,-13.7455674859957,-8.1826,-11.1206,5
"9247",1,15,10,-5,-13.1187996240426,-0.1826,4.8794,-3
"9248",1,18,0,-18,-22.7586987366968,12.8174,14.8794,0
"9249",1,20,8,-12,-20.423628164573,6.8174,6.8794,2
"9250",1,30,7,-23,-34.1241859969884,17.8174,7.8794,12
"9251",1,17,2,-15,-20.3928075937738,9.8174,12.8794,-1
"9252",1,22,18,-4,-17.1667731618664,-1.1826,-3.1206,4
"9253",1,16,5,-11,-17.1804918066884,5.8174,9.8794,-2
"9254",1,18,9,-9,-17.6378234401947,3.8174,5.8794,0
"9255",1,20,18,-2,-14.8624043427976,-3.1826,-3.1206,2
"9256",1,23,14,-9,-21.0596197389664,3.8174,0.8794,5
"9257",1,15,19,4,-7.66532736496442,-9.1826,-4.1206,-3
"9258",1,21,4,-17,-24.4227927678884,11.8174,10.8794,3
"9259",1,17,13,-4,-13.8063411732302,-1.1826,1.8794,-1
"9260",1,19,30,11,-6.02315473248814,-16.1826,-15.1206,1
"9261",1,19,0,-19,-24.1874488351757,13.8174,14.8794,1
"9262",1,22,2,-20,-26.6168432462425,14.8174,12.8794,4
"9263",1,19,23,4,-10.3114452380298,-9.1826,-8.1206,1
"9264",1,23,8,-15,-24.5910565207698,9.8174,6.8794,5
"9265",1,14,29,15,-0.468673754235116,-20.1826,-14.1206,-4
"9266",1,17,29,12,-4.04219788307623,-17.1826,-14.1206,-1
"9267",1,18,16,-2,-13.1207554476776,-3.1826,-1.1206,0
"9268",1,16,22,6,-7.12662125030378,-11.1826,-7.1206,-2
"9269",1,23,23,0,-15.4916440300046,-5.1826,-8.1206,5
"9270",1,22,27,5,-11.7857042566506,-10.1826,-12.1206,4
"9271",1,13,23,10,-2.85535595157151,-15.1826,-8.1206,-5
"9272",1,12,0,-12,-15.0683400943892,6.8174,14.8794,-6
"9273",1,27,20,-7,-22.5059920259761,1.8174,-5.1206,9
"9274",1,14,21,7,-4.97078669857259,-12.1826,-6.1206,-4
"9275",1,22,25,3,-12.872526407427,-8.1826,-10.1206,4
"9276",1,15,28,13,-2.22062511812091,-18.1826,-13.1206,-3
"9277",1,28,17,-11,-25.6111082869908,5.8174,-2.1206,10
"9278",1,18,29,11,-5.33536382107034,-16.1826,-14.1206,0
"9279",1,14,2,-12,-16.3769489232335,6.8174,12.8794,-4
"9280",1,21,13,-8,-18.8121976126502,2.8174,1.8794,3
"9281",1,27,5,-22,-31.4762274157328,16.8174,9.8794,9
"9282",1,20,23,3,-11.5771611384836,-8.1826,-8.1206,2
"9283",1,15,2,-13,-17.8140401617688,7.8174,12.8794,-3
"9284",1,20,30,10,-7.42198107340809,-15.1826,-15.1206,2
"9285",1,12,1,-11,-14.4551514428219,5.8174,13.8794,-6
"9286",1,12,5,-7,-12.055482214453,1.8174,9.8794,-6
"9287",1,28,16,-12,-26.3429130560686,6.8174,-1.1206,10
"9288",1,12,27,15,1.01292708559453,-20.1826,-12.1206,-6
"9289",1,18,11,-7,-16.2256988878699,1.8174,3.8794,0
"9290",1,21,4,-17,-24.3515905101898,11.8174,10.8794,3
"9291",1,29,23,-6,-23.4333042477862,0.8174,-8.1206,11
"9292",1,15,23,8,-5.11963463918512,-13.1826,-8.1206,-3
"9293",1,25,17,-8,-21.7002044722179,2.8174,-2.1206,7
"9294",1,34,26,-8,-28.0928597191653,2.8174,-11.1206,16
"9295",1,16,2,-14,-19.0811766319993,8.8174,12.8794,-2
"9296",1,27,4,-23,-32.1134753527934,17.8174,10.8794,9
"9297",1,17,14,-3,-13.2331665961387,-2.1826,0.8794,-1
"9298",1,31,3,-28,-37.8468667610233,22.8174,11.8794,13
"9299",1,15,10,-5,-12.8519763706874,-0.1826,4.8794,-3
"9300",1,21,5,-16,-23.6353084834685,10.8174,9.8794,3
"9301",1,26,26,0,-17.5160395390373,-5.1826,-11.1206,8
"9302",1,20,11,-9,-18.9720083806913,3.8174,3.8794,2
"9303",1,21,25,4,-11.6533554709778,-9.1826,-10.1206,3
"9304",1,19,23,4,-10.7055295037744,-9.1826,-8.1206,1
"9305",1,17,23,6,-7.87500028016558,-11.1826,-8.1206,-1
"9306",1,18,23,5,-9.1075708753027,-10.1826,-8.1206,0
"9307",1,16,19,3,-9.06176695327301,-8.1826,-4.1206,-2
"9308",1,19,10,-9,-18.0085158400519,3.8174,4.8794,1
"9309",1,18,29,11,-5.39077106076603,-16.1826,-14.1206,0
"9310",1,14,27,13,-1.56947439780956,-18.1826,-12.1206,-4
"9311",1,20,2,-18,-24.3646290887771,12.8174,12.8794,2
"9312",1,15,7,-8,-15.0225303837616,2.8174,7.8794,-3
"9313",1,25,6,-19,-28.4449859149622,13.8174,8.8794,7
"9314",1,18,4,-14,-20.3625589417555,8.8174,10.8794,0
"9315",1,21,27,6,-10.4101657350168,-11.1826,-12.1206,3
"9316",1,19,16,-3,-14.5953625800967,-2.1826,-1.1206,1
"9317",1,14,29,15,-0.386113897770225,-20.1826,-14.1206,-4
"9318",1,27,21,-6,-22.1324792892579,0.8174,-6.1206,9
"9319",1,20,5,-15,-22.3442358839106,9.8174,9.8794,2
"9320",1,13,1,-12,-16.0120826389391,6.8174,13.8794,-5
"9321",1,21,2,-19,-25.2073157369658,13.8174,12.8794,3
"9322",1,25,24,-1,-17.4870122409857,-4.1826,-9.1206,7
"9323",1,25,30,5,-14.3243280367253,-10.1826,-15.1206,7
"9324",1,17,7,-10,-17.5345968995285,4.8174,7.8794,-1
"9325",1,27,20,-7,-22.7266463437416,1.8174,-5.1206,9
"9326",1,22,25,3,-13.0437381922899,-8.1826,-10.1206,4
"9327",1,18,5,-13,-19.789864082532,7.8174,9.8794,0
"9328",1,18,5,-13,-19.7641866909003,7.8174,9.8794,0
"9329",1,16,17,1,-10.0868461598249,-6.1826,-2.1206,-2
"9330",1,14,17,3,-7.72801827173269,-8.1826,-2.1206,-4
"9331",1,19,25,6,-9.17048821996083,-11.1826,-10.1206,1
"9332",1,18,12,-6,-15.8090987765517,0.8174,2.8794,0
"9333",1,23,11,-12,-23.0088239321522,6.8174,3.8794,5
"9334",1,19,16,-3,-14.6191417802008,-2.1826,-1.1206,1
"9335",1,20,19,-1,-14.0952920356453,-4.1826,-4.1206,2
"9336",1,24,27,3,-14.1767934214593,-8.1826,-12.1206,6
"9337",1,19,3,-16,-22.406026174939,10.8174,11.8794,1
"9338",1,25,26,1,-16.3310604957148,-6.1826,-11.1206,7
"9339",1,15,20,5,-6.96752027399401,-10.1826,-5.1206,-3
"9340",1,22,3,-19,-26.5131678544304,13.8174,11.8794,4
"9341",1,26,0,-26,-33.0405806010569,20.8174,14.8794,8
"9342",1,16,22,6,-6.9481915413387,-11.1826,-7.1206,-2
"9343",1,26,1,-25,-32.6193755919578,19.8174,13.8794,8
"9344",1,24,28,4,-13.7728513980846,-9.1826,-13.1206,6
"9345",1,17,17,0,-11.3532041920543,-5.1826,-2.1206,-1
"9346",1,24,5,-19,-27.8122110982432,13.8174,9.8794,6
"9347",1,16,8,-8,-15.4355030378395,2.8174,6.8794,-2
"9348",1,29,17,-12,-26.8783915013635,6.8174,-2.1206,11
"9349",1,20,12,-8,-18.43288527706,2.8174,2.8794,2
"9350",1,17,1,-16,-21.0768617772046,10.8174,13.8794,-1
"9351",1,14,0,-14,-17.9011593831872,8.8174,14.8794,-4
"9352",1,27,0,-27,-34.7402444183631,21.8174,14.8794,9
"9353",1,18,24,6,-8.2627588572792,-11.1826,-9.1206,0
"9354",1,20,26,6,-9.87968082308705,-11.1826,-11.1206,2
"9355",1,28,2,-26,-34.7111522746357,20.8174,12.8794,10
"9356",1,20,18,-2,-14.3698636557267,-3.1826,-3.1206,2
"9357",1,20,24,4,-11.175928407641,-9.1826,-9.1206,2
"9358",1,19,20,1,-12.103536997642,-6.1826,-5.1206,1
"9359",1,22,28,6,-11.2154843000824,-11.1826,-13.1206,4
"9360",1,23,13,-10,-21.5700096023493,4.8174,1.8794,5
"9361",1,17,18,1,-10.7836788055996,-6.1826,-3.1206,-1
"9362",1,22,8,-14,-23.1607723385492,8.8174,6.8794,4
"9363",1,22,23,1,-14.1886538330603,-6.1826,-8.1206,4
"9364",1,21,23,2,-13.0238136211302,-7.1826,-8.1206,3
"9365",1,24,9,-15,-25.4073206228041,9.8174,5.8794,6
"9366",1,25,27,2,-15.6644885673842,-7.1826,-12.1206,7
"9367",1,22,12,-10,-21.2250651415123,4.8174,2.8794,4
"9368",1,29,28,-1,-20.2666436445717,-4.1826,-13.1206,11
"9369",1,25,6,-19,-28.5520895857387,13.8174,8.8794,7
"9370",1,27,24,-3,-20.0498171259882,-2.1826,-9.1206,9
"9371",1,22,8,-14,-23.2219306387511,8.8174,6.8794,4
"9372",1,22,26,4,-12.8707951875828,-9.1826,-11.1206,4
"9373",1,23,9,-14,-24.1439071241801,8.8174,5.8794,5
"9374",1,20,2,-18,-24.61840032122,12.8174,12.8794,2
"9375",1,20,25,5,-10.2467201488666,-10.1826,-10.1206,2
"9376",1,23,15,-8,-20.2612689090592,2.8174,-0.1206,5
"9377",1,11,15,4,-4.84853684601607,-9.1826,-0.1206,-7
"9378",1,11,5,-6,-10.8381889967656,0.8174,9.8794,-7
"9379",1,18,16,-2,-13.4221863447827,-3.1826,-1.1206,0
"9380",1,18,9,-9,-17.5744498852294,3.8174,5.8794,0
"9381",1,21,27,6,-10.5392895425862,-11.1826,-12.1206,3
"9382",1,22,23,1,-14.1131011585833,-6.1826,-8.1206,4
"9383",1,28,8,-20,-30.8527286466706,14.8174,6.8794,10
"9384",1,26,3,-23,-31.7043033053713,17.8174,11.8794,8
"9385",1,23,16,-7,-19.7567569256114,1.8174,-1.1206,5
"9386",1,14,2,-12,-16.6083651188166,6.8174,12.8794,-4
"9387",1,27,5,-22,-31.4516732222078,16.8174,9.8794,9
"9388",1,24,21,-3,-18.1393098707765,-2.1826,-6.1206,6
"9389",1,21,9,-12,-21.2573437281834,6.8174,5.8794,3
"9390",1,27,6,-21,-31.0082493772206,15.8174,8.8794,9
"9391",1,20,27,7,-9.19183367919115,-12.1826,-12.1206,2
"9392",1,13,14,1,-8.08035258572128,-6.1826,0.8794,-5
"9393",1,25,6,-19,-28.4998863607752,13.8174,8.8794,7
"9394",1,15,22,7,-5.77101523013529,-12.1826,-7.1206,-3
"9395",1,25,27,2,-15.9274736943996,-7.1826,-12.1206,7
"9396",1,17,17,0,-11.5402387993848,-5.1826,-2.1206,-1
"9397",1,23,26,3,-13.8008330711262,-8.1826,-11.1206,5
"9398",1,19,30,11,-6.0682860791221,-16.1826,-15.1206,1
"9399",1,32,15,-17,-32.0992259040826,11.8174,-0.1206,14
"9400",1,14,11,-3,-11.0705628310418,-2.1826,3.8794,-4
"9401",1,20,13,-7,-17.8039609698015,1.8174,1.8794,2
"9402",1,15,0,-15,-18.8384785859374,9.8174,14.8794,-3
"9403",1,17,1,-16,-20.8973434263513,10.8174,13.8794,-1
"9404",1,15,20,5,-7.069817180193,-10.1826,-5.1206,-3
"9405",1,19,0,-19,-24.1398312948288,13.8174,14.8794,1
"9406",1,11,13,2,-6.03948670236255,-7.1826,1.8794,-7
"9407",1,15,11,-4,-12.445107655993,-1.1826,3.8794,-3
"9408",1,21,16,-5,-17.187748666359,-0.1826,-1.1206,3
"9409",1,21,12,-9,-19.6817999764626,3.8174,2.8794,3
"9410",1,15,3,-12,-17.0152332458361,6.8174,11.8794,-3
"9411",1,21,20,-1,-15.0639054413172,-4.1826,-5.1206,3
"9412",1,23,17,-6,-19.4181109301537,0.8174,-2.1206,5
"9413",1,15,9,-6,-13.4322239004735,0.8174,5.8794,-3
"9414",1,21,12,-9,-19.4872804671684,3.8174,2.8794,3
"9415",1,24,11,-13,-24.2736253313661,7.8174,3.8794,6
"9416",1,15,29,14,-1.37340160549562,-19.1826,-14.1206,-3
"9417",1,16,3,-13,-18.3073602572449,7.8174,11.8794,-2
"9418",1,19,15,-4,-15.2743294998739,-1.1826,-0.1206,1
"9419",1,31,18,-13,-29.0752010372082,7.8174,-3.1206,13
"9420",1,15,22,7,-5.90104081183293,-12.1826,-7.1206,-3
"9421",1,18,23,5,-9.23550362687806,-10.1826,-8.1206,0
"9422",1,21,0,-21,-26.8114808558339,15.8174,14.8794,3
"9423",1,17,0,-17,-21.6255967055811,11.8174,14.8794,-1
"9424",1,20,0,-20,-25.6057754922973,14.8174,14.8794,2
"9425",1,22,21,-1,-15.5775685668888,-4.1826,-6.1206,4
"9426",1,18,11,-7,-16.5550552871842,1.8174,3.8794,0
"9427",1,19,27,8,-7.76690205380571,-13.1826,-12.1206,1
"9428",1,25,18,-7,-21.0076434250326,1.8174,-3.1206,7
"9429",1,14,3,-11,-15.7476024538692,5.8174,11.8794,-4
"9430",1,25,20,-5,-20.2079436384672,-0.1826,-5.1206,7
"9431",1,18,28,10,-5.87541801157795,-15.1826,-13.1206,0
"9432",1,23,1,-22,-28.8787269583864,16.8174,13.8794,5
"9433",1,23,6,-17,-25.9197369880474,11.8174,8.8794,5
"9434",1,20,13,-7,-17.630286200938,1.8174,1.8794,2
"9435",1,19,5,-14,-21.3960084419334,8.8174,9.8794,1
"9436",1,19,12,-7,-16.9300884963282,1.8174,2.8794,1
"9437",1,22,29,7,-10.5477148471869,-12.1826,-14.1206,4
"9438",1,18,6,-12,-19.1935791824181,6.8174,8.8794,0
"9439",1,15,20,5,-6.90326177306592,-10.1826,-5.1206,-3
"9440",1,17,0,-17,-21.5730757204915,11.8174,14.8794,-1
"9441",1,15,15,0,-10.1932609093313,-5.1826,-0.1206,-3
"9442",1,16,22,6,-6.97194702208118,-11.1826,-7.1206,-2
"9443",1,23,2,-21,-28.246978285789,15.8174,12.8794,5
"9444",1,12,22,10,-1.79663058946918,-15.1826,-7.1206,-6
"9445",1,25,24,-1,-17.6750033107024,-4.1826,-9.1206,7
"9446",1,25,28,3,-15.2829752552024,-8.1826,-13.1206,7
"9447",1,15,21,6,-6.40447254904509,-11.1826,-6.1206,-3
"9448",1,26,19,-7,-21.9255753175318,1.8174,-4.1206,8
"9449",1,12,28,16,1.48970713853694,-21.1826,-13.1206,-6
"9450",1,21,18,-3,-16.1088099103286,-2.1826,-3.1206,3
"9451",1,29,9,-20,-32.0101403913569,14.8174,5.8794,11
"9452",1,20,23,3,-11.7788681518544,-8.1826,-8.1206,2
"9453",1,20,13,-7,-17.6717411840587,1.8174,1.8794,2
"9454",1,26,24,-2,-19.034710837827,-3.1826,-9.1206,8
"9455",1,17,22,5,-8.31929772670459,-10.1826,-7.1206,-1
"9456",1,16,17,1,-9.88984254860062,-6.1826,-2.1206,-2
"9457",1,26,3,-23,-31.4489204531763,17.8174,11.8794,8
"9458",1,15,1,-14,-18.2882666745432,8.8174,13.8794,-3
"9459",1,20,25,5,-10.459694346386,-10.1826,-10.1206,2
"9460",1,15,3,-12,-17.560187012566,6.8174,11.8794,-3
"9461",1,19,22,3,-10.8142823514608,-8.1826,-7.1206,1
"9462",1,13,15,2,-7.39516555275465,-7.1826,-0.1206,-5
"9463",1,25,11,-14,-25.3472699389276,8.8174,3.8794,7
"9464",1,21,8,-13,-22.4009867547422,7.8174,6.8794,3
"9465",1,28,2,-26,-34.7020808996142,20.8174,12.8794,10
"9466",1,22,2,-20,-27.0617588549463,14.8174,12.8794,4
"9467",1,10,26,16,3.13440876676708,-21.1826,-11.1206,-8
"9468",1,18,21,3,-10.059465909712,-8.1826,-6.1206,0
"9469",1,17,17,0,-11.4120492708607,-5.1826,-2.1206,-1
"9470",1,18,28,10,-5.88530301606079,-15.1826,-13.1206,0
"9471",1,24,11,-13,-24.3166453220482,7.8174,3.8794,6
"9472",1,21,9,-12,-21.403014166897,6.8174,5.8794,3
"9473",1,16,19,3,-8.9316951381699,-8.1826,-4.1206,-2
"9474",1,18,15,-3,-13.9275032744716,-2.1826,-0.1206,0
"9475",1,37,5,-32,-44.7985705468512,26.8174,9.8794,19
"9476",1,28,23,-5,-21.868816100327,-0.1826,-8.1206,10
"9477",1,16,8,-8,-15.4598327035546,2.8174,6.8794,-2
"9478",1,23,3,-20,-27.5323842301514,14.8174,11.8794,5
"9479",1,17,14,-3,-13.0006016367381,-2.1826,0.8794,-1
"9480",1,26,26,0,-17.8944377883743,-5.1826,-11.1206,8
"9481",1,21,26,5,-11.1233077415994,-10.1826,-11.1206,3
"9482",1,21,1,-20,-26.0349103233201,14.8174,13.8794,3
"9483",1,12,10,-2,-8.98439022536421,-3.1826,4.8794,-6
"9484",1,17,12,-5,-14.49188933814,-0.1826,2.8794,-1
"9485",1,27,9,-18,-29.1225767110275,12.8174,5.8794,9
"9486",1,19,11,-8,-17.6154022501775,2.8174,3.8794,1
"9487",1,21,3,-18,-24.8681627952973,12.8174,11.8794,3
"9488",1,20,25,5,-10.4761517447767,-10.1826,-10.1206,2
"9489",1,21,4,-17,-24.5062940367026,11.8174,10.8794,3
"9490",1,29,17,-12,-27.1383964370918,6.8174,-2.1206,11
"9491",1,18,15,-3,-13.7197233043697,-2.1826,-0.1206,0
"9492",1,22,2,-20,-26.8874506891172,14.8174,12.8794,4
"9493",1,25,16,-9,-22.5166921532474,3.8174,-1.1206,7
"9494",1,25,24,-1,-17.8180461328503,-4.1826,-9.1206,7
"9495",1,19,12,-7,-16.7226470465493,1.8174,2.8794,1
"9496",1,14,3,-11,-16.0588092330934,5.8174,11.8794,-4
"9497",1,18,6,-12,-19.5476416717604,6.8174,8.8794,0
"9498",1,22,14,-8,-19.7837708873083,2.8174,0.8794,4
"9499",1,21,30,9,-8.71339556320495,-14.1826,-15.1206,3
"9500",1,20,18,-2,-14.8014085644488,-3.1826,-3.1206,2
"9501",1,21,3,-18,-25.0044779108112,12.8174,11.8794,3
"9502",1,20,0,-20,-25.6507458434349,14.8174,14.8794,2
"9503",1,13,15,2,-7.08976468738447,-7.1826,-0.1206,-5
"9504",1,25,27,2,-15.8820175505294,-7.1826,-12.1206,7
"9505",1,19,5,-14,-21.4421711943042,8.8174,9.8794,1
"9506",1,13,25,12,-1.25437613161766,-17.1826,-10.1206,-5
"9507",1,20,26,6,-9.73526042234678,-11.1826,-11.1206,2
"9508",1,24,7,-17,-26.5108273030107,11.8174,7.8794,6
"9509",1,16,16,0,-10.5844858760576,-5.1826,-1.1206,-2
"9510",1,22,26,4,-12.5331810143767,-9.1826,-11.1206,4
"9511",1,18,18,0,-11.9184566498185,-5.1826,-3.1206,0
"9512",1,17,13,-4,-13.7660057271113,-1.1826,1.8794,-1
"9513",1,16,7,-9,-16.3895793726806,3.8174,7.8794,-2
"9514",1,20,13,-7,-17.8144680894419,1.8174,1.8794,2
"9515",1,29,29,0,-20.0499109225786,-5.1826,-14.1206,11
"9516",1,13,30,17,1.26251924742325,-22.1826,-15.1206,-5
"9517",1,24,18,-6,-19.7842487652282,0.8174,-3.1206,6
"9518",1,20,25,5,-10.4762741961343,-10.1826,-10.1206,2
"9519",1,17,16,-1,-12.0693829049341,-4.1826,-1.1206,-1
"9520",1,17,22,5,-8.45303557735822,-10.1826,-7.1206,-1
"9521",1,19,6,-13,-20.5274331643121,7.8174,8.8794,1
"9522",1,26,21,-5,-20.9822264237037,-0.1826,-6.1206,8
"9523",1,18,5,-13,-19.8096887659956,7.8174,9.8794,0
"9524",1,11,11,0,-6.91804238444061,-5.1826,3.8794,-7
"9525",1,19,29,10,-6.76524038885745,-15.1826,-14.1206,1
"9526",1,13,24,11,-1.86984520760149,-16.1826,-9.1206,-5
"9527",1,14,2,-12,-16.7486516369983,6.8174,12.8794,-4
"9528",1,24,15,-9,-21.5978750377697,3.8174,-0.1206,6
"9529",1,23,19,-4,-17.8470719190323,-1.1826,-4.1206,5
"9530",1,22,7,-15,-23.8545042644632,9.8174,7.8794,4
"9531",1,18,10,-8,-16.906742961145,2.8174,4.8794,0
"9532",1,26,17,-9,-22.9805968986398,3.8174,-2.1206,8
"9533",1,25,2,-23,-30.8688914421316,17.8174,12.8794,7
"9534",1,16,7,-9,-15.8955599496043,3.8174,7.8794,-2
"9535",1,19,12,-7,-16.8586613436466,1.8174,2.8794,1
"9536",1,17,30,13,-3.57352225257811,-18.1826,-15.1206,-1
"9537",1,19,15,-4,-15.4081260230891,-1.1826,-0.1206,1
"9538",1,19,12,-7,-16.8212973867692,1.8174,2.8794,1
"9539",1,24,23,-1,-16.7824455606586,-4.1826,-8.1206,6
"9540",1,14,1,-13,-16.8995600341112,7.8174,13.8794,-4
"9541",1,20,3,-17,-23.484642601559,11.8174,11.8794,2
"9542",1,29,17,-12,-27.0004307967657,6.8174,-2.1206,11
"9543",1,25,17,-8,-21.6526847420663,2.8174,-2.1206,7
"9544",1,25,8,-17,-27.0765892436194,11.8174,6.8794,7
"9545",1,18,15,-3,-13.6855539954553,-2.1826,-0.1206,0
"9546",1,17,22,5,-8.52352855298565,-10.1826,-7.1206,-1
"9547",1,18,8,-10,-18.1550204500819,4.8174,6.8794,0
"9548",1,20,24,4,-10.8782648050695,-9.1826,-9.1206,2
"9549",1,26,29,3,-15.8675927261143,-8.1826,-14.1206,8
"9550",1,19,30,11,-6.3295783348128,-16.1826,-15.1206,1
"9551",1,17,18,1,-11.0659035956115,-6.1826,-3.1206,-1
"9552",1,18,10,-8,-17.0171321218403,2.8174,4.8794,0
"9553",1,24,22,-2,-17.6839745217156,-3.1826,-7.1206,6
"9554",1,28,25,-3,-20.992329063113,-2.1826,-10.1206,10
"9555",1,18,29,11,-5.6284581255425,-16.1826,-14.1206,0
"9556",1,23,18,-5,-18.4887978521759,-0.1826,-3.1206,5
"9557",1,27,14,-13,-26.1799068527271,7.8174,0.8794,9
"9558",1,18,1,-17,-22.3220912612681,11.8174,13.8794,0
"9559",1,27,30,3,-16.3174103621102,-8.1826,-15.1206,9
"9560",1,24,20,-4,-18.5841717094378,-1.1826,-5.1206,6
"9561",1,12,4,-8,-12.6688732547187,2.8174,10.8794,-6
"9562",1,18,24,6,-8.52689402419762,-11.1826,-9.1206,0
"9563",1,21,28,7,-10.197797818268,-12.1826,-13.1206,3
"9564",1,25,1,-24,-31.3459871621698,18.8174,13.8794,7
"9565",1,21,1,-20,-26.1905119501926,14.8174,13.8794,3
"9566",1,22,3,-19,-26.3711841795812,13.8174,11.8794,4
"9567",1,19,0,-19,-24.2473656896449,13.8174,14.8794,1
"9568",1,21,30,9,-8.7778366222193,-14.1826,-15.1206,3
"9569",1,22,20,-2,-16.194780137125,-3.1826,-5.1206,4
"9570",1,24,24,0,-16.2304593035679,-5.1826,-9.1206,6
"9571",1,24,10,-14,-24.6903864915933,8.8174,4.8794,6
"9572",1,18,8,-10,-18.1792787462461,4.8174,6.8794,0
"9573",1,16,12,-4,-13.2280233374972,-1.1826,2.8794,-2
"9574",1,14,27,13,-1.44400466854397,-18.1826,-12.1206,-4
"9575",1,17,6,-11,-18.0266366409935,5.8174,8.8794,-1
"9576",1,22,5,-17,-24.9451151130077,11.8174,9.8794,4
"9577",1,12,18,6,-4.41547915548467,-11.1826,-3.1206,-6
"9578",1,17,10,-7,-15.6783157135232,1.8174,4.8794,-1
"9579",1,18,5,-13,-19.8104384473893,7.8174,9.8794,0
"9580",1,25,2,-23,-30.7937950145372,17.8174,12.8794,7
"9581",1,19,24,5,-9.63066206184891,-10.1826,-9.1206,1
"9582",1,17,6,-11,-18.1984886531655,5.8174,8.8794,-1
"9583",1,16,2,-14,-19.1576055090524,8.8174,12.8794,-2
"9584",1,19,20,1,-12.3334319217174,-6.1826,-5.1206,1
"9585",1,23,20,-3,-17.5464294933017,-2.1826,-5.1206,5
"9586",1,21,1,-20,-26.1845117412771,14.8174,13.8794,3
"9587",1,19,7,-12,-20.0419086095242,6.8174,7.8794,1
"9588",1,14,2,-12,-16.4578287999296,6.8174,12.8794,-4
"9589",1,23,26,3,-13.6976491813478,-8.1826,-11.1206,5
"9590",1,18,6,-12,-19.4310252481572,6.8174,8.8794,0
"9591",1,22,19,-3,-16.5018365499276,-2.1826,-4.1206,4
"9592",1,16,5,-11,-17.5431228461187,5.8174,9.8794,-2
"9593",1,18,28,10,-6.06857890377303,-15.1826,-13.1206,0
"9594",1,23,12,-11,-22.0719478217683,5.8174,2.8794,5
"9595",1,25,9,-16,-27.1489616921073,10.8174,5.8794,7
"9596",1,19,20,1,-12.1719886391498,-6.1826,-5.1206,1
"9597",1,23,11,-12,-22.7707816973658,6.8174,3.8794,5
"9598",1,16,1,-15,-19.8447036161217,9.8174,13.8794,-2
"9599",1,14,6,-8,-14.0835596055364,2.8174,8.8794,-4
"9600",1,29,20,-9,-25.1949381056685,3.8174,-5.1206,11
"9601",1,24,20,-4,-18.8492271802237,-1.1826,-5.1206,6
"9602",1,15,9,-6,-13.5645235086979,0.8174,5.8794,-3
"9603",1,19,19,0,-12.928056252834,-5.1826,-4.1206,1
"9604",1,22,17,-5,-17.9460350477944,-0.1826,-2.1206,4
"9605",1,22,8,-14,-23.0965707680844,8.8174,6.8794,4
"9606",1,11,17,6,-3.50515243160412,-11.1826,-2.1206,-7
"9607",1,20,22,2,-12.2688173641146,-7.1826,-7.1206,2
"9608",1,26,5,-21,-30.2155887251909,15.8174,9.8794,8
"9609",1,23,24,1,-14.946703649297,-6.1826,-9.1206,5
"9610",1,24,3,-21,-28.8890336683805,15.8174,11.8794,6
"9611",1,18,22,4,-9.64509241566983,-9.1826,-7.1206,0
"9612",1,25,20,-5,-20.0251966057618,-0.1826,-5.1206,7
"9613",1,19,15,-4,-15.1434815803683,-1.1826,-0.1206,1
"9614",1,32,5,-27,-38.1415744075141,21.8174,9.8794,14
"9615",1,19,30,11,-6.24720135643707,-16.1826,-15.1206,1
"9616",1,28,11,-17,-29.4626684425648,11.8174,3.8794,10
"9617",1,17,30,13,-3.61474478525406,-18.1826,-15.1206,-1
"9618",1,23,20,-3,-17.7228385688519,-2.1826,-5.1206,5
"9619",1,24,5,-19,-27.5901914034555,13.8174,9.8794,6
"9620",1,17,25,8,-6.7613870428,-13.1826,-10.1206,-1
"9621",1,23,25,2,-14.4194454063987,-7.1826,-10.1206,5
"9622",1,22,23,1,-13.9457586247197,-6.1826,-8.1206,4
"9623",1,21,1,-20,-25.9917350445235,14.8174,13.8794,3
"9624",1,18,9,-9,-17.5988150952089,3.8174,5.8794,0
"9625",1,23,11,-12,-22.7189789382932,6.8174,3.8794,5
"9626",1,22,3,-19,-26.1917243105007,13.8174,11.8794,4
"9627",1,19,21,2,-11.7112961668023,-7.1826,-6.1206,1
"9628",1,25,23,-2,-18.2795277896122,-3.1826,-8.1206,7
"9629",1,18,16,-2,-13.2214616491521,-3.1826,-1.1206,0
"9630",1,23,3,-20,-27.401094253607,14.8174,11.8794,5
"9631",1,21,10,-11,-20.7107680155039,5.8174,4.8794,3
"9632",1,16,12,-4,-13.153483530796,-1.1826,2.8794,-2
"9633",1,26,22,-4,-19.966717368451,-1.1826,-7.1206,8
"9634",1,24,0,-24,-30.8232360125167,18.8174,14.8794,6
"9635",1,22,26,4,-12.4918479459294,-9.1826,-11.1206,4
"9636",1,18,2,-16,-21.7020387694071,10.8174,12.8794,0
"9637",1,24,23,-1,-16.8630661134836,-4.1826,-8.1206,6
"9638",1,30,8,-22,-33.8737048202914,16.8174,6.8794,12
"9639",1,19,15,-4,-15.1363590789596,-1.1826,-0.1206,1
"9640",1,24,15,-9,-21.6589247428346,3.8174,-0.1206,6
"9641",1,19,17,-2,-13.7338665230081,-3.1826,-2.1206,1
"9642",1,23,29,6,-12.1568961600445,-11.1826,-14.1206,5
"9643",1,18,21,3,-10.3842313207987,-8.1826,-6.1206,0
"9644",1,15,29,14,-1.30701740171032,-19.1826,-14.1206,-3
"9645",1,18,9,-9,-17.5060404005905,3.8174,5.8794,0
"9646",1,17,24,7,-7.2776626548814,-12.1826,-9.1206,-1
"9647",1,28,8,-20,-31.14115885072,14.8174,6.8794,10
"9648",1,22,26,4,-12.3084551541978,-9.1826,-11.1206,4
"9649",1,24,1,-23,-30.0736902160867,17.8174,13.8794,6
"9650",1,20,16,-4,-15.6019097304069,-1.1826,-1.1206,2
"9651",1,24,5,-19,-27.5960310083843,13.8174,9.8794,6
"9652",1,16,11,-5,-13.4701327368799,-0.1826,3.8794,-2
"9653",1,22,3,-19,-26.4134675637701,13.8174,11.8794,4
"9654",1,24,9,-15,-25.397041574903,9.8174,5.8794,6
"9655",1,17,15,-2,-12.676622706744,-3.1826,-0.1206,-1
"9656",1,16,14,-2,-11.6840175090546,-3.1826,0.8794,-2
"9657",1,27,10,-17,-28.5475649464844,11.8174,4.8794,9
"9658",1,23,24,1,-15.0862219697248,-6.1826,-9.1206,5
"9659",1,14,23,9,-3.80724155422166,-14.1826,-8.1206,-4
"9660",1,13,18,5,-5.69179055178002,-10.1826,-3.1206,-5
"9661",1,30,6,-24,-35.0932833267364,18.8174,8.8794,12
"9662",1,27,23,-4,-20.8199969612944,-1.1826,-8.1206,9
"9663",1,16,30,14,-2.32820910362647,-19.1826,-15.1206,-2
"9664",1,18,0,-18,-23.0054433626903,12.8174,14.8794,0
"9665",1,16,22,6,-7.17634408820571,-11.1826,-7.1206,-2
"9666",1,21,30,9,-9.10715231180615,-14.1826,-15.1206,3
"9667",1,22,18,-4,-17.3685614457731,-1.1826,-3.1206,4
"9668",1,24,27,3,-14.7502293899621,-8.1826,-12.1206,6
"9669",1,16,29,13,-3.02908528475891,-18.1826,-14.1206,-2
"9670",1,20,23,3,-11.5665831040844,-8.1826,-8.1206,2
"9671",1,19,21,2,-11.5332481968783,-7.1826,-6.1206,1
"9672",1,24,0,-24,-30.8093891544922,18.8174,14.8794,6
"9673",1,21,21,0,-14.4638878396179,-5.1826,-6.1206,3
"9674",1,25,11,-14,-25.4412533305176,8.8174,3.8794,7
"9675",1,18,30,12,-4.86023165660396,-17.1826,-15.1206,0
"9676",1,23,15,-8,-20.4105045165853,2.8174,-0.1206,5
"9677",1,16,16,0,-10.7828152578527,-5.1826,-1.1206,-2
"9678",1,18,24,6,-8.55587147099673,-11.1826,-9.1206,0
"9679",1,25,22,-3,-19.0199133583411,-2.1826,-7.1206,7
"9680",1,19,22,3,-10.9449782736282,-8.1826,-7.1206,1
"9681",1,22,2,-20,-26.9167947959509,14.8174,12.8794,4
"9682",1,18,27,9,-6.592453077393,-14.1826,-12.1206,0
"9683",1,20,11,-9,-19.0994571344263,3.8174,3.8794,2
"9684",1,21,12,-9,-19.6115800992452,3.8174,2.8794,3
"9685",1,23,5,-18,-26.4032110074651,12.8174,9.8794,5
"9686",1,20,0,-20,-25.9217308387647,14.8174,14.8794,2
"9687",1,17,30,13,-3.38417595356224,-18.1826,-15.1206,-1
"9688",1,17,0,-17,-21.5218987217537,11.8174,14.8794,-1
"9689",1,26,0,-26,-33.3525356944808,20.8174,14.8794,8
"9690",1,20,14,-6,-17.0816350293694,0.8174,0.8794,2
"9691",1,14,26,12,-1.89821765335496,-17.1826,-11.1206,-4
"9692",1,21,18,-3,-15.7850249225001,-2.1826,-3.1206,3
"9693",1,14,30,16,0.0815287400611072,-21.1826,-15.1206,-4
"9694",1,15,14,-1,-10.507426340316,-4.1826,0.8794,-3
"9695",1,18,25,7,-7.55680580777463,-12.1826,-10.1206,0
"9696",1,20,24,4,-11.0739754466085,-9.1826,-9.1206,2
"9697",1,20,18,-2,-14.5984186408455,-3.1826,-3.1206,2
"9698",1,22,30,8,-9.90147744464536,-13.1826,-15.1206,4
"9699",1,16,18,2,-9.6264880253798,-7.1826,-3.1206,-2
"9700",1,11,22,11,-0.742702148186195,-16.1826,-7.1206,-7
"9701",1,23,12,-11,-22.381189537664,5.8174,2.8794,5
"9702",1,15,18,3,-8.26877694336468,-8.1826,-3.1206,-3
"9703",1,15,11,-4,-12.3641792300662,-1.1826,3.8794,-3
"9704",1,27,16,-11,-24.8608745265714,5.8174,-1.1206,9
"9705",1,19,12,-7,-17.0606960046589,1.8174,2.8794,1
"9706",1,23,26,3,-13.8257418086988,-8.1826,-11.1206,5
"9707",1,21,23,2,-13.196773821497,-7.1826,-8.1206,3
"9708",1,23,9,-14,-23.8538034522271,8.8174,5.8794,5
"9709",1,19,22,3,-11.1001620606965,-8.1826,-7.1206,1
"9710",1,22,15,-7,-19.337725323203,1.8174,-0.1206,4
"9711",1,28,12,-16,-28.5439138962685,10.8174,2.8794,10
"9712",1,19,29,10,-6.68512571059971,-15.1826,-14.1206,1
"9713",1,16,22,6,-7.11340373118781,-11.1826,-7.1206,-2
"9714",1,16,9,-7,-14.7302998772003,1.8174,5.8794,-2
"9715",1,31,19,-12,-28.2657341369296,6.8174,-4.1206,13
"9716",1,28,9,-19,-30.3780204091627,13.8174,5.8794,10
"9717",1,22,19,-3,-16.6833564377998,-2.1826,-4.1206,4
"9718",1,23,23,0,-15.892519580718,-5.1826,-8.1206,5
"9719",1,15,13,-2,-11.1944177997746,-3.1826,1.8794,-3
"9720",1,21,9,-12,-21.3312109417372,6.8174,5.8794,3
"9721",1,22,30,8,-10.2190191614556,-13.1826,-15.1206,4
"9722",1,21,26,5,-11.3094403781826,-10.1826,-11.1206,3
"9723",1,24,19,-5,-19.3141799474532,-0.1826,-4.1206,6
"9724",1,18,20,2,-11.0486540469593,-7.1826,-5.1206,0
"9725",1,21,0,-21,-26.7633297400736,15.8174,14.8794,3
"9726",1,15,4,-11,-16.6311199369107,5.8174,10.8794,-3
"9727",1,19,1,-18,-23.4948398722579,12.8174,13.8794,1
"9728",1,20,9,-11,-20.2703471451115,5.8174,5.8794,2
"9729",1,33,21,-12,-29.6919153078777,6.8174,-6.1206,15
"9730",1,18,6,-12,-19.1734562636959,6.8174,8.8794,0
"9731",1,21,30,9,-8.68382819947638,-14.1826,-15.1206,3
"9732",1,21,5,-16,-24.0596991960862,10.8174,9.8794,3
"9733",1,14,8,-6,-12.6202517726659,0.8174,6.8794,-4
"9734",1,30,19,-11,-27.0054600540506,5.8174,-4.1206,12
"9735",1,19,24,5,-9.80224906951625,-10.1826,-9.1206,1
"9736",1,26,14,-12,-24.7180301258828,6.8174,0.8794,8
"9737",1,11,10,-1,-7.75590955745603,-4.1826,4.8794,-7
"9738",1,12,19,7,-3.56580617524394,-12.1826,-4.1206,-6
"9739",1,20,26,6,-10.0721752584957,-11.1826,-11.1206,2
"9740",1,16,9,-7,-14.9607534430695,1.8174,5.8794,-2
"9741",1,24,11,-13,-24.0738496664765,7.8174,3.8794,6
"9742",1,23,28,5,-12.6490580262285,-10.1826,-13.1206,5
"9743",1,29,2,-27,-36.0934727067922,21.8174,12.8794,11
"9744",1,19,26,7,-8.71676314467957,-12.1826,-11.1206,1
"9745",1,19,17,-2,-14.0434916223088,-3.1826,-2.1206,1
"9746",1,26,29,3,-16.0091006671651,-8.1826,-14.1206,8
"9747",1,25,18,-7,-21.2286687175442,1.8174,-3.1206,7
"9748",1,22,18,-4,-17.4806389926124,-1.1826,-3.1206,4
"9749",1,28,3,-25,-34.0575693717857,19.8174,11.8794,10
"9750",1,19,18,-1,-13.3072618446003,-4.1826,-3.1206,1
"9751",1,20,7,-13,-21.2491293141102,7.8174,7.8794,2
"9752",1,23,6,-17,-25.7805593883213,11.8174,8.8794,5
"9753",1,23,25,2,-14.3182917486332,-7.1826,-10.1206,5
"9754",1,25,28,3,-15.4689373948369,-8.1826,-13.1206,7
"9755",1,17,25,8,-6.52422064679817,-13.1826,-10.1206,-1
"9756",1,25,15,-10,-23.1392042694724,4.8174,-0.1206,7
"9757",1,24,26,2,-15.2103118935964,-7.1826,-11.1206,6
"9758",1,15,13,-2,-11.0577802534878,-3.1826,1.8794,-3
"9759",1,22,3,-19,-26.3225947520909,13.8174,11.8794,4
"9760",1,25,28,3,-15.4354446735731,-8.1826,-13.1206,7
"9761",1,22,5,-17,-25.1119637826335,11.8174,9.8794,4
"9762",1,19,20,1,-12.0753216972889,-6.1826,-5.1206,1
"9763",1,23,11,-12,-23.2151441423615,6.8174,3.8794,5
"9764",1,21,1,-20,-26.1516756256613,14.8174,13.8794,3
"9765",1,22,16,-6,-18.6864534833685,0.8174,-1.1206,4
"9766",1,25,11,-14,-25.2552394800339,8.8174,3.8794,7
"9767",1,24,19,-5,-19.4948069991847,-0.1826,-4.1206,6
"9768",1,16,19,3,-8.90779489766328,-8.1826,-4.1206,-2
"9769",1,18,21,3,-10.2089800867584,-8.1826,-6.1206,0
"9770",1,22,13,-9,-20.4065151425339,3.8174,1.8794,4
"9771",1,24,17,-7,-20.6364488991303,1.8174,-2.1206,6
"9772",1,26,1,-25,-33.0130656635119,19.8174,13.8794,8
"9773",1,18,22,4,-9.60234329412635,-9.1826,-7.1206,0
"9774",1,24,8,-16,-25.9789646997109,10.8174,6.8794,6
"9775",1,20,30,10,-7.7464326031013,-15.1826,-15.1206,2
"9776",1,27,10,-17,-28.5148865474768,11.8174,4.8794,9
"9777",1,19,5,-14,-21.1955883366268,8.8174,9.8794,1
"9778",1,21,21,0,-14.2750369275849,-5.1826,-6.1206,3
"9779",1,22,0,-22,-27.9969686275113,16.8174,14.8794,4
"9780",1,8,25,17,4.9386774437971,-22.1826,-10.1206,-10
"9781",1,20,26,6,-9.93278147870076,-11.1826,-11.1206,2
"9782",1,20,11,-9,-19.0298539020876,3.8174,3.8794,2
"9783",1,16,3,-13,-18.5253575593366,7.8174,11.8794,-2
"9784",1,14,7,-7,-13.3403412387286,1.8174,7.8794,-4
"9785",1,15,2,-13,-17.9432809980996,7.8174,12.8794,-3
"9786",1,19,10,-9,-18.174085560643,3.8174,4.8794,1
"9787",1,21,2,-19,-25.7065512396959,13.8174,12.8794,3
"9788",1,14,3,-11,-15.8411666501356,5.8174,11.8794,-4
"9789",1,21,29,8,-9.50911636518721,-13.1826,-14.1206,3
"9790",1,19,8,-11,-19.4296572021004,5.8174,6.8794,1
"9791",1,22,11,-11,-21.5260122686103,5.8174,3.8794,4
"9792",1,20,12,-8,-18.4884792943124,2.8174,2.8794,2
"9793",1,13,12,-1,-8.93431760700973,-4.1826,2.8794,-5
"9794",1,19,26,7,-8.26075672475698,-12.1826,-11.1206,1
"9795",1,15,6,-9,-15.4996134101179,3.8174,8.8794,-3
"9796",1,15,6,-9,-15.5089555547125,3.8174,8.8794,-3
"9797",1,15,28,13,-2.14209999087104,-18.1826,-13.1206,-3
"9798",1,14,26,12,-2.02998971549616,-17.1826,-11.1206,-4
"9799",1,24,30,6,-12.8555695613105,-11.1826,-15.1206,6
"9800",1,21,15,-6,-17.8825492690893,0.8174,-0.1206,3
"9801",1,21,22,1,-13.4501962052381,-6.1826,-7.1206,3
"9802",1,20,15,-5,-16.3496286747785,-0.1826,-0.1206,2
"9803",1,27,1,-26,-33.9545542238267,20.8174,13.8794,9
"9804",1,17,12,-5,-14.2575417332241,-0.1826,2.8794,-1
"9805",1,28,30,2,-17.9567595621351,-7.1826,-15.1206,10
"9806",1,27,21,-6,-22.0852557084662,0.8174,-6.1206,9
"9807",1,20,29,9,-8.20426378321041,-14.1826,-14.1206,2
"9808",1,18,20,2,-11.029396744022,-7.1826,-5.1206,0
"9809",1,14,22,8,-4.6683465953135,-13.1826,-7.1206,-4
"9810",1,23,20,-3,-17.5242483925445,-2.1826,-5.1206,5
"9811",1,17,22,5,-8.61216305096604,-10.1826,-7.1206,-1
"9812",1,20,11,-9,-18.9128715733723,3.8174,3.8794,2
"9813",1,15,26,11,-3.27144523868843,-16.1826,-11.1206,-3
"9814",1,21,1,-20,-26.096711553376,14.8174,13.8794,3
"9815",1,18,3,-15,-20.9688722239255,9.8174,11.8794,0
"9816",1,17,0,-17,-21.5082643642508,11.8174,14.8794,-1
"9817",1,24,19,-5,-19.3333906751669,-0.1826,-4.1206,6
"9818",1,13,15,2,-7.38317867059508,-7.1826,-0.1206,-5
"9819",1,21,1,-20,-26.1466012277349,14.8174,13.8794,3
"9820",1,20,16,-4,-15.7881819962675,-1.1826,-1.1206,2
"9821",1,19,3,-16,-22.6936531886351,10.8174,11.8794,1
"9822",1,22,21,-1,-15.5866502554933,-4.1826,-6.1206,4
"9823",1,17,26,9,-6.0049120498802,-14.1826,-11.1206,-1
"9824",1,24,27,3,-14.6425522640136,-8.1826,-12.1206,6
"9825",1,17,25,8,-6.62026559991219,-13.1826,-10.1206,-1
"9826",1,23,18,-5,-18.4011969413762,-0.1826,-3.1206,5
"9827",1,18,17,-1,-12.6614194411511,-4.1826,-2.1206,0
"9828",1,22,22,0,-14.7884058730623,-5.1826,-7.1206,4
"9829",1,18,22,4,-9.87511452761717,-9.1826,-7.1206,0
"9830",1,23,14,-9,-20.9518077702887,3.8174,0.8794,5
"9831",1,15,30,15,-0.944552298788204,-20.1826,-15.1206,-3
"9832",1,21,20,-1,-15.2358859063662,-4.1826,-5.1206,3
"9833",1,15,10,-5,-12.8910630311211,-0.1826,4.8794,-3
"9834",1,16,20,4,-8.19873279174126,-9.1826,-5.1206,-2
"9835",1,21,4,-17,-24.5612629116939,11.8174,10.8794,3
"9836",1,20,6,-14,-21.8472067204448,8.8174,8.8794,2
"9837",1,22,13,-9,-20.3628591203123,3.8174,1.8794,4
"9838",1,21,18,-3,-15.9038785088086,-2.1826,-3.1206,3
"9839",1,15,13,-2,-11.2490744538572,-3.1826,1.8794,-3
"9840",1,22,20,-2,-15.8795099511044,-3.1826,-5.1206,4
"9841",1,19,17,-2,-14.0641495652199,-3.1826,-2.1206,1
"9842",1,16,11,-5,-13.5722080101202,-0.1826,3.8794,-2
"9843",1,25,26,1,-16.2751836155693,-6.1826,-11.1206,7
"9844",1,18,3,-15,-21.3029818277125,9.8174,11.8794,0
"9845",1,11,8,-3,-9.298161696206,-2.1826,6.8794,-7
"9846",1,22,19,-3,-16.6039985557084,-2.1826,-4.1206,4
"9847",1,27,14,-13,-26.4341142221041,7.8174,0.8794,9
"9848",1,23,23,0,-15.6019765638503,-5.1826,-8.1206,5
"9849",1,13,1,-12,-15.5837746609973,6.8174,13.8794,-5
"9850",1,21,21,0,-14.0437755903688,-5.1826,-6.1206,3
"9851",1,23,23,0,-15.6075307809787,-5.1826,-8.1206,5
"9852",1,16,15,-1,-11.4559223031952,-4.1826,-0.1206,-2
"9853",1,16,2,-14,-19.1707894560665,8.8174,12.8794,-2
"9854",1,15,10,-5,-12.6224255160638,-0.1826,4.8794,-3
"9855",1,20,6,-14,-21.9406780654033,8.8174,8.8794,2
"9856",1,12,11,-1,-8.46799200835943,-4.1826,3.8794,-6
"9857",1,10,13,3,-4.71128999164809,-8.1826,1.8794,-8
"9858",1,24,12,-12,-23.3414978004313,6.8174,2.8794,6
"9859",1,27,8,-19,-29.6262332723456,13.8174,6.8794,9
"9860",1,15,0,-15,-19.0447360407359,9.8174,14.8794,-3
"9861",1,22,12,-10,-20.5580084258683,4.8174,2.8794,4
"9862",1,22,20,-2,-16.1648064232153,-3.1826,-5.1206,4
"9863",1,15,27,12,-2.8210709320408,-17.1826,-12.1206,-3
"9864",1,22,19,-3,-16.8038337868583,-2.1826,-4.1206,4
"9865",1,19,26,7,-8.46038752747903,-12.1826,-11.1206,1
"9866",1,16,12,-4,-13.0939937372809,-1.1826,2.8794,-2
"9867",1,18,16,-2,-13.2770801111481,-3.1826,-1.1206,0
"9868",1,24,7,-17,-26.3735913957941,11.8174,7.8794,6
"9869",1,16,17,1,-10.0683661031344,-6.1826,-2.1206,-2
"9870",1,21,0,-21,-26.9263267910294,15.8174,14.8794,3
"9871",1,17,8,-9,-16.8821980914297,3.8174,6.8794,-1
"9872",1,25,11,-14,-25.2969191608644,8.8174,3.8794,7
"9873",1,19,14,-5,-15.878970322819,-0.1826,0.8794,1
"9874",1,26,18,-8,-22.6048404678499,2.8174,-3.1206,8
"9875",1,16,3,-13,-18.6256491583645,7.8174,11.8794,-2
"9876",1,15,13,-2,-11.354693149015,-3.1826,1.8794,-3
"9877",1,15,26,11,-3.40383955899555,-16.1826,-11.1206,-3
"9878",1,19,18,-1,-13.4195771302171,-4.1826,-3.1206,1
"9879",1,20,22,2,-12.4008640207002,-7.1826,-7.1206,2
"9880",1,15,0,-15,-19.2005043885144,9.8174,14.8794,-3
"9881",1,29,3,-26,-35.2816976530944,20.8174,11.8794,11
"9882",1,30,7,-23,-34.2025669482797,17.8174,7.8794,12
"9883",1,21,11,-10,-19.9218833265572,4.8174,3.8794,3
"9884",1,24,8,-16,-25.8860087015927,10.8174,6.8794,6
"9885",1,13,22,9,-2.94728784537006,-14.1826,-7.1206,-5
"9886",1,27,28,1,-17.7506984248351,-6.1826,-13.1206,9
"9887",1,14,29,15,-0.374120043798451,-20.1826,-14.1206,-4
"9888",1,26,10,-16,-27.433206820909,10.8174,4.8794,8
"9889",1,12,2,-10,-13.6415002903885,4.8174,12.8794,-6
"9890",1,17,25,8,-6.70800279922082,-13.1826,-10.1206,-1
"9891",1,18,23,5,-9.18971874489921,-10.1826,-8.1206,0
"9892",1,16,23,7,-6.79229737250859,-12.1826,-8.1206,-2
"9893",1,22,7,-15,-23.9751745734483,9.8174,7.8794,4
"9894",1,31,13,-18,-32.0250861662173,12.8174,1.8794,13
"9895",1,31,15,-16,-30.8804983206299,10.8174,-0.1206,13
"9896",1,21,0,-21,-26.7476639180172,15.8174,14.8794,3
"9897",1,20,21,1,-13.184281009146,-6.1826,-6.1206,2
"9898",1,13,28,15,0.0245667764650829,-20.1826,-13.1206,-5
"9899",1,19,9,-10,-18.8119090271376,4.8174,5.8794,1
"9900",1,19,23,4,-10.3847549563956,-9.1826,-8.1206,1
"9901",1,21,21,0,-14.2376120833639,-5.1826,-6.1206,3
"9902",1,9,24,15,3.16821832454586,-20.1826,-9.1206,-9
"9903",1,18,12,-6,-15.5027909566212,0.8174,2.8794,0
"9904",1,25,14,-11,-23.4072334889682,5.8174,0.8794,7
"9905",1,20,4,-16,-23.3369227649247,10.8174,10.8794,2
"9906",1,24,18,-6,-20.014434119308,0.8174,-3.1206,6
"9907",1,17,17,0,-11.3880055973082,-5.1826,-2.1206,-1
"9908",1,23,14,-9,-20.9813579219939,3.8174,0.8794,5
"9909",1,21,28,7,-9.82756295707901,-12.1826,-13.1206,3
"9910",1,25,24,-1,-17.2976888804167,-4.1826,-9.1206,7
"9911",1,22,4,-18,-25.7626977966872,12.8174,10.8794,4
"9912",1,15,21,6,-6.75376948760727,-11.1826,-6.1206,-3
"9913",1,18,28,10,-6.25500451483772,-15.1826,-13.1206,0
"9914",1,18,25,7,-8.03953332334125,-12.1826,-10.1206,0
"9915",1,18,22,4,-9.59130276702564,-9.1826,-7.1206,0
"9916",1,19,14,-5,-15.8633935625027,-0.1826,0.8794,1
"9917",1,16,12,-4,-13.1933927508534,-1.1826,2.8794,-2
"9918",1,22,9,-13,-22.6396528035825,7.8174,5.8794,4
"9919",1,17,18,1,-10.9309246430268,-6.1826,-3.1206,-1
"9920",1,24,4,-20,-28.3322599369271,14.8174,10.8794,6
"9921",1,23,4,-19,-26.7752414632598,13.8174,10.8794,5
"9922",1,30,6,-24,-35.2943930347726,18.8174,8.8794,12
"9923",1,23,5,-18,-26.1061734124138,12.8174,9.8794,5
"9924",1,15,19,4,-7.62846655321795,-9.1826,-4.1206,-3
"9925",1,17,17,0,-11.4194414368234,-5.1826,-2.1206,-1
"9926",1,12,8,-4,-10.3158587916031,-1.1826,6.8794,-6
"9927",1,17,22,5,-8.4368288171022,-10.1826,-7.1206,-1
"9928",1,20,9,-11,-20.0845588729535,5.8174,5.8794,2
"9929",1,18,12,-6,-15.6859384548674,0.8174,2.8794,0
"9930",1,21,29,8,-9.27415533763797,-13.1826,-14.1206,3
"9931",1,16,16,0,-10.827384136369,-5.1826,-1.1206,-2
"9932",1,28,19,-9,-24.5238631674175,3.8174,-4.1206,10
"9933",1,18,19,1,-11.6427375705507,-6.1826,-4.1206,0
"9934",1,23,24,1,-14.9140139514333,-6.1826,-9.1206,5
"9935",1,28,0,-28,-35.8281953174819,22.8174,14.8794,10
"9936",1,12,12,0,-8.23389066429449,-5.1826,2.8794,-6
"9937",1,14,29,15,-0.290753903877213,-20.1826,-14.1206,-4
"9938",1,15,15,0,-10.1806032115095,-5.1826,-0.1206,-3
"9939",1,20,11,-9,-18.8442733822986,3.8174,3.8794,2
"9940",1,14,14,0,-9.26222759969659,-5.1826,0.8794,-4
"9941",1,22,19,-3,-16.7649470832526,-2.1826,-4.1206,4
"9942",1,26,14,-12,-25.0980839378349,6.8174,0.8794,8
"9943",1,19,29,10,-6.87548790632334,-15.1826,-14.1206,1
"9944",1,24,17,-7,-20.1995014826153,1.8174,-2.1206,6
"9945",1,21,3,-18,-24.9626163334846,12.8174,11.8794,3
"9946",1,12,18,6,-4.03091030194471,-11.1826,-3.1206,-6
"9947",1,25,2,-23,-31.0261957448456,17.8174,12.8794,7
"9948",1,20,21,1,-12.8327201622855,-6.1826,-6.1206,2
"9949",1,21,28,7,-9.71280004298444,-12.1826,-13.1206,3
"9950",1,16,27,11,-4.08761149408783,-16.1826,-12.1206,-2
"9951",1,17,29,12,-4.20100978728668,-17.1826,-14.1206,-1
"9952",1,17,8,-9,-16.6886785574512,3.8174,6.8794,-1
"9953",1,19,3,-16,-22.3235438723697,10.8174,11.8794,1
"9954",1,21,13,-8,-18.7859106012969,2.8174,1.8794,3
"9955",1,30,30,0,-20.463236204728,-5.1826,-15.1206,12
"9956",1,8,28,20,7.01725215394192,-25.1826,-13.1206,-10
"9957",1,22,18,-4,-17.2392569309235,-1.1826,-3.1206,4
"9958",1,18,25,7,-7.95905485843648,-12.1826,-10.1206,0
"9959",1,26,17,-9,-23.382410259768,3.8174,-2.1206,8
"9960",1,21,28,7,-10.229258138296,-12.1826,-13.1206,3
"9961",1,22,7,-15,-24.0688384973172,9.8174,7.8794,4
"9962",1,23,15,-8,-20.4610419685798,2.8174,-0.1206,5
"9963",1,19,5,-14,-21.2054852609632,8.8174,9.8794,1
"9964",1,20,1,-19,-24.7794451988755,13.8174,13.8794,2
"9965",1,26,16,-10,-23.5893675896698,4.8174,-1.1206,8
"9966",1,19,30,11,-6.19981962108678,-16.1826,-15.1206,1
"9967",1,30,15,-15,-29.5668313390132,9.8174,-0.1206,12
"9968",1,22,13,-9,-20.2159671828987,3.8174,1.8794,4
"9969",1,22,4,-18,-25.1527385818063,12.8174,10.8794,4
"9970",1,22,9,-13,-22.8125491142491,7.8174,5.8794,4
"9971",1,22,23,1,-14.2815686356039,-6.1826,-8.1206,4
"9972",1,18,3,-15,-21.0085156152949,9.8174,11.8794,0
"9973",1,23,14,-9,-20.8053597300484,3.8174,0.8794,5
"9974",1,19,28,9,-7.2374638694769,-14.1826,-13.1206,1
"9975",1,19,21,2,-11.604321027173,-7.1826,-6.1206,1
"9976",1,17,0,-17,-21.6280747838555,11.8174,14.8794,-1
"9977",1,20,14,-6,-17.2054527230643,0.8174,0.8794,2
"9978",1,16,10,-6,-14.150232369724,0.8174,4.8794,-2
"9979",1,12,4,-8,-12.9017373392522,2.8174,10.8794,-6
"9980",1,22,0,-22,-28.1706842388104,16.8174,14.8794,4
"9981",1,23,26,3,-13.7033527859666,-8.1826,-11.1206,5
"9982",1,13,7,-6,-12.3873842703559,0.8174,7.8794,-5
"9983",1,16,1,-15,-19.6265889655505,9.8174,13.8794,-2
"9984",1,18,24,6,-8.32673920860078,-11.1826,-9.1206,0
"9985",1,18,4,-14,-20.5606202976544,8.8174,10.8794,0
"9986",1,14,2,-12,-16.607572957758,6.8174,12.8794,-4
"9987",1,22,3,-19,-26.3828024542236,13.8174,11.8794,4
"9988",1,20,3,-17,-23.6768445595414,11.8174,11.8794,2
"9989",1,20,30,10,-7.48957060724986,-15.1826,-15.1206,2
"9990",1,21,23,2,-12.8566444363569,-7.1826,-8.1206,3
"9991",1,12,21,9,-2.51295535412105,-14.1826,-6.1206,-6
"9992",1,22,3,-19,-26.4124437726167,13.8174,11.8794,4
"9993",1,21,7,-14,-22.4544595464687,8.8174,7.8794,3
"9994",1,17,22,5,-8.37142884357632,-10.1826,-7.1206,-1
"9995",1,18,3,-15,-21.0968583667967,9.8174,11.8794,0
"9996",1,12,10,-2,-8.99928087517093,-3.1826,4.8794,-6
"9997",1,21,20,-1,-14.6428140137324,-4.1826,-5.1206,3
"9998",1,22,1,-21,-27.7828522705455,15.8174,13.8794,4
"9999",1,14,3,-11,-16.0246056276996,5.8174,11.8794,-4
"10000",1,22,10,-12,-21.9947709585068,6.8174,4.8794,4
